rating,pitcher,travel,adj_rating,win_prob,ou
1599,0,0,1599,0.65,1
1497,-28,24,1493,0.35,0
1597,12,-4,1605,0.61,1
1499,5,24,1528,0.39,0
1562,5,0,1567,0.57,0
1500,-9,24,1515,0.43,0
1565,4,0,1569,0.51,0
1497,38,24,1559,0.49,1
1564,-10,0,1554,0.55,1
1498,2,22,1522,0.45,1
1500,-26,0,1474,0.49,1
1463,-6,24,1481,0.51,1
1501,2,0,1503,0.54,0
1461,-9,24,1476,0.46,0
1502,-13,0,1489,0.46,1
1461,29,24,1514,0.54,1
1504,-23,-3,1478,0.49,0
1459,3,24,1486,0.51,1
1502,36,0,1538,0.54,1
1501,-15,24,1510,0.46,0
1503,4,-1,1506,0.42,0
1500,40,21,1561,0.58,0
1504,-26,0,1478,0.35,0
1562,1,24,1587,0.65,1
1506,6,0,1512,0.43,0
1560,-20,24,1564,0.57,1
1508,-1,-1,1506,0.39,0
1558,4,24,1586,0.61,1
1519,17,0,1536,0.46,0
1507,32,24,1563,0.54,1
1516,-3,0,1513,0.51,1
1509,-25,24,1508,0.49,1
1517,-2,-4,1511,0.47,0
1508,0,24,1532,0.53,1
1500,1,0,1501,0.48,0
1507,-20,24,1511,0.52,0
1498,21,0,1519,0.47,1
1509,6,24,1539,0.53,0
1497,-8,-2,1487,0.43,1
1510,2,26,1538,0.57,0
1453,-4,0,1449,0.35,0
1509,26,24,1559,0.65,1
1451,6,0,1457,0.41,1
1510,-10,24,1524,0.59,1
1449,-8,-2,1439,0.36,1
1513,3,21,1537,0.64,0
1510,-20,0,1490,0.43,1
1494,21,24,1539,0.57,0
1508,-30,0,1478,0.47,0
1495,-17,24,1502,0.53,0
1507,6,0,1513,0.5,1
1497,-7,24,1514,0.5,0
1510,10,0,1520,0.48,0
1494,18,24,1536,0.52,1
1508,22,-3,1527,0.52,1
1496,-9,24,1511,0.48,0
1509,-6,0,1503,0.37,0
1586,-17,24,1593,0.63,1
1510,2,1,1513,0.35,0
1585,9,24,1618,0.65,0
1544,-15,0,1529,0.48,1
1512,5,24,1541,0.52,0
1546,-4,0,1542,0.5,1
1510,8,24,1542,0.5,1
1544,-21,1,1524,0.5,1
1512,-15,24,1521,0.5,0
1537,5,0,1542,0.48,0
1510,19,24,1553,0.52,1
1536,7,0,1543,0.52,0
1511,-8,24,1527,0.48,0
1535,-19,0,1516,0.51,1
1512,-30,24,1506,0.49,1
1534,-7,-2,1525,0.49,0
1513,0,20,1533,0.51,0
1514,6,0,1520,0.48,1
1521,-8,24,1537,0.52,1
1516,11,0,1527,0.44,0
1519,27,24,1570,0.56,1
1519,-15,-1,1503,0.47,0
1516,-16,26,1526,0.53,1
1520,-11,0,1509,0.38,0
1573,-1,24,1596,0.62,0
1522,26,2,1550,0.42,0
1571,6,26,1603,0.58,1
1524,3,-2,1525,0.42,0
1569,-12,23,1580,0.58,1
1549,3,0,1552,0.49,1
1525,7,24,1556,0.51,1
1548,-20,0,1528,0.46,1
1526,5,24,1555,0.54,1
1547,23,0,1570,0.55,1
1527,-18,24,1533,0.45,0
1545,-21,-2,1522,0.42,1
1529,25,24,1578,0.58,0
1471,-18,0,1453,0.37,1
1532,-11,24,1545,0.63,0
1473,16,-1,1488,0.4,0
1531,-2,26,1555,0.6,1
1452,-8,0,1444,0.34,0
1530,3,24,1557,0.66,1
1453,34,0,1487,0.41,0
1529,0,24,1553,0.59,1
1452,-5,0,1447,0.37,1
1531,-12,23,1542,0.63,0
1532,26,0,1558,0.57,1
1472,16,24,1512,0.43,1
1535,-6,0,1529,0.56,1
1469,-7,24,1486,0.44,1
1536,5,-4,1537,0.55,1
1468,9,24,1501,0.45,1
1535,0,0,1535,0.54,1
1455,32,24,1511,0.46,0
1533,-7,0,1526,0.61,1
1457,-32,24,1449,0.39,0
1534,-22,0,1512,0.56,0
1456,-9,24,1471,0.44,1
1533,-21,0,1512,0.58,0
1457,-19,20,1458,0.42,0
1527,19,0,1546,0.45,1
1534,26,24,1584,0.55,0
1530,15,0,1545,0.51,0
1531,-19,24,1536,0.49,1
1533,-10,-3,1520,0.44,0
1528,9,24,1561,0.56,1
1464,-9,0,1455,0.36,1
1527,5,24,1556,0.64,1
1462,5,0,1467,0.38,1
1530,1,24,1555,0.62,0
1463,-11,-3,1449,0.39,0
1529,-25,20,1524,0.61,0
1526,23,0,1549,0.51,1
1523,-8,24,1539,0.49,0
1524,-19,0,1505,0.47,1
1526,-22,24,1528,0.53,1
1525,10,-3,1532,0.49,0
1524,-9,24,1539,0.51,1
1527,7,0,1534,0.46,0
1527,14,24,1565,0.54,0
1526,1,0,1527,0.52,1
1528,-40,24,1512,0.48,1
1528,-26,0,1502,0.48,0
1526,-34,24,1516,0.52,1
1525,-17,-4,1504,0.39,1
1528,28,24,1580,0.61,0
1493,4,0,1497,0.46,0
1524,-24,24,1524,0.54,1
1494,-3,0,1491,0.39,1
1522,25,24,1571,0.61,1
1496,-2,0,1494,0.42,0
1521,2,24,1547,0.58,1
1497,33,-4,1526,0.48,0
1519,-2,24,1541,0.52,0
1432,11,0,1443,0.39,1
1519,-23,24,1520,0.61,1
1430,-25,0,1405,0.3,1
1520,11,24,1555,0.7,1
1428,-1,-2,1425,0.37,1
1522,-27,23,1518,0.63,0
1520,22,0,1542,0.49,1
1542,-15,24,1551,0.51,0
1517,3,0,1520,0.44,1
1545,-6,24,1563,0.56,0
1519,5,-2,1522,0.45,0
1543,-3,20,1560,0.55,1
1517,-21,0,1496,0.52,1
1465,-9,24,1480,0.48,0
1515,10,0,1525,0.55,1
1467,-3,24,1488,0.45,0
1513,-24,0,1489,0.5,1
1468,-5,24,1487,0.5,1
1516,26,-1,1541,0.55,1
1466,13,26,1505,0.45,1
1486,-28,0,1458,0.38,0
1515,1,24,1540,0.62,1
1488,-19,-2,1467,0.4,0
1514,-1,24,1537,0.6,1
1546,-1,0,1545,0.54,1
1515,-22,24,1517,0.46,0
1548,40,0,1588,0.56,0
1514,7,24,1545,0.44,0
1545,-12,0,1533,0.52,1
1516,-23,24,1517,0.48,1
1544,-10,-3,1531,0.45,0
1518,26,24,1568,0.55,0
1590,-20,0,1570,0.49,1
1560,-8,24,1576,0.51,1
1591,-6,4,1589,0.49,0
1559,2,31,1592,0.51,0
1434,-37,0,1397,0.27,1
1561,-16,24,1569,0.73,0
1434,-19,0,1415,0.24,0
1560,31,24,1615,0.76,1
1432,8,0,1440,0.32,1
1563,-17,21,1567,0.68,0
1562,5,0,1567,0.57,0
1500,-9,24,1515,0.43,0
1565,4,0,1569,0.51,0
1497,38,24,1559,0.49,1
1564,-10,0,1554,0.55,1
1498,2,22,1522,0.45,1
1563,-21,0,1542,0.61,1
1432,5,24,1461,0.39,0
1564,4,0,1568,0.69,0
1430,-23,24,1431,0.31,0
1563,-14,-4,1545,0.62,1
1432,3,26,1461,0.38,0
1450,-11,0,1439,0.26,0
1562,34,24,1620,0.74,1
1447,6,0,1453,0.3,1
1564,11,24,1599,0.7,1
1448,10,0,1458,0.33,1
1564,-7,24,1581,0.67,1
1449,-7,-3,1439,0.32,1
1563,-18,24,1569,0.68,1
1504,-26,0,1478,0.35,0
1562,1,24,1587,0.65,1
1506,6,0,1512,0.43,0
1560,-20,24,1564,0.57,1
1508,-1,-1,1506,0.39,0
1558,4,24,1586,0.61,1
1589,2,-3,1588,0.53,0
1557,-8,21,1570,0.47,0
1556,29,0,1585,0.53,0
1543,-5,24,1562,0.47,0
1553,1,1,1555,0.5,1
1546,-15,23,1554,0.5,0
1554,-20,0,1534,0.39,0
1586,-1,24,1609,0.61,1
1552,0,0,1552,0.4,0
1588,14,24,1626,0.6,0
1550,32,0,1582,0.45,0
1589,3,24,1616,0.55,0
1551,3,-3,1551,0.41,1
1589,1,21,1611,0.59,1
1546,-10,0,1536,0.45,0
1550,-3,24,1571,0.55,1
1548,-29,-3,1516,0.44,0
1548,-20,26,1554,0.56,1
1526,21,0,1547,0.46,0
1547,1,24,1572,0.54,1
1522,-7,0,1515,0.36,1
1550,40,24,1614,0.64,0
1525,13,-1,1537,0.45,0
1548,3,24,1575,0.55,1
1545,-6,0,1539,0.58,1
1481,-23,24,1482,0.42,0
1544,-22,0,1522,0.51,1
1482,8,24,1514,0.49,0
1546,-1,-2,1543,0.58,0
1480,-14,21,1487,0.42,1
1499,-20,0,1479,0.32,1
1545,42,24,1611,0.68,1
1496,-40,0,1456,0.33,1
1548,4,24,1576,0.67,0
1494,17,-3,1508,0.41,1
1550,-1,26,1575,0.59,1
1496,22,0,1518,0.44,1
1552,-18,24,1558,0.56,0
1497,-5,0,1492,0.33,0
1551,38,24,1613,0.67,1
1495,20,-2,1513,0.41,1
1553,1,21,1575,0.59,1
1552,2,0,1554,0.62,1
1451,-5,24,1470,0.38,1
1555,-4,0,1551,0.63,0
1447,-10,24,1461,0.37,1
1553,-18,-2,1533,0.56,1
1450,20,23,1493,0.44,0
1552,38,0,1590,0.67,1
1447,-5,24,1466,0.33,1
1551,3,0,1554,0.56,0
1448,39,24,1511,0.44,0
1549,-3,-3,1543,0.6,1
1449,1,24,1474,0.4,0
1548,-5,0,1543,0.54,0
1494,-1,24,1517,0.46,0
1551,-11,0,1540,0.51,0
1492,17,24,1533,0.49,1
1554,46,-2,1598,0.62,0
1489,-5,26,1510,0.38,1
1497,7,0,1504,0.4,0
1553,-2,24,1575,0.6,0
1499,-12,0,1487,0.38,0
1552,-4,24,1572,0.62,1
1496,7,-3,1500,0.4,1
1555,-5,24,1574,0.6,0
1474,-11,0,1463,0.36,0
1553,-14,24,1563,0.64,1
1474,8,0,1482,0.31,0
1553,46,24,1623,0.69,0
1472,8,0,1480,0.37,0
1555,-4,24,1575,0.63,0
1473,-19,-2,1452,0.34,0
1554,-6,20,1568,0.66,1
1556,0,0,1556,0.53,0
1519,-7,24,1536,0.47,1
1553,-9,0,1544,0.48,1
1522,11,24,1557,0.52,1
1554,-15,-2,1537,0.53,0
1521,-22,20,1519,0.47,1
1553,46,0,1599,0.66,1
1465,-8,24,1481,0.34,0
1556,1,0,1557,0.61,1
1462,-6,24,1480,0.39,1
1554,-11,-3,1540,0.57,1
1463,3,24,1490,0.43,0
1552,-3,0,1549,0.5,1
1518,3,24,1545,0.5,0
1549,-9,0,1540,0.5,1
1521,-5,24,1540,0.5,0
1547,42,-1,1588,0.53,1
1523,21,26,1570,0.47,0
1463,-9,0,1454,0.36,0
1546,-16,24,1554,0.64,1
1463,9,0,1472,0.38,0
1545,-9,24,1560,0.62,0
1464,-14,0,1450,0.34,0
1545,-5,24,1564,0.66,0
1465,1,-3,1463,0.36,0
1544,-8,24,1560,0.64,0
1505,-25,0,1480,0.32,0
1543,45,24,1612,0.68,1
1507,3,0,1510,0.42,0
1541,4,24,1569,0.58,1
1508,3,-3,1508,0.45,0
1540,-18,21,1543,0.55,0
1540,-8,0,1532,0.41,0
1553,19,24,1596,0.59,0
1541,-3,0,1538,0.43,0
1552,13,24,1589,0.57,0
1539,-5,-3,1531,0.47,1
1555,-29,24,1550,0.53,1
1539,44,0,1583,0.64,0
1465,-4,24,1485,0.36,0
1538,6,0,1544,0.58,1
1466,-5,24,1485,0.42,0
1536,-21,0,1515,0.55,1
1468,-11,24,1481,0.45,0
1538,-9,-2,1527,0.55,0
1466,10,20,1496,0.45,1
1555,-24,0,1531,0.46,1
1537,0,24,1561,0.54,1
1554,21,0,1575,0.52,0
1538,-3,24,1559,0.48,0
1553,-15,-4,1534,0.39,1
1540,47,26,1613,0.61,0
1520,22,0,1542,0.49,1
1542,-15,24,1551,0.51,0
1517,3,0,1520,0.44,1
1545,-6,24,1563,0.56,0
1519,5,-2,1522,0.45,0
1543,-3,20,1560,0.55,1
1545,0,0,1545,0.54,0
1502,-9,24,1517,0.46,1
1544,39,0,1583,0.58,1
1503,-2,24,1525,0.42,0
1547,-13,-1,1533,0.51,0
1500,5,20,1525,0.49,1
1548,-5,0,1543,0.57,0
1456,12,24,1492,0.43,0
1548,-5,0,1543,0.58,0
1457,3,26,1486,0.42,0
1546,-1,0,1545,0.54,1
1515,-22,24,1517,0.46,0
1548,40,0,1588,0.56,0
1514,7,24,1545,0.44,0
1545,-12,0,1533,0.52,1
1516,-23,24,1517,0.48,1
1544,-10,-3,1531,0.45,0
1518,26,24,1568,0.55,0
1457,-15,0,1442,0.43,0
1433,31,24,1488,0.57,1
1455,12,3,1470,0.54,1
1435,-18,27,1444,0.46,0
1434,-37,0,1397,0.27,1
1561,-16,24,1569,0.73,0
1434,-19,0,1415,0.24,0
1560,31,24,1615,0.76,1
1432,8,0,1440,0.32,1
1563,-17,21,1567,0.68,0
1433,-1,0,1432,0.37,0
1479,19,24,1522,0.63,1
1429,-5,0,1424,0.4,1
1482,-12,24,1494,0.6,1
1430,-16,-4,1410,0.4,1
1482,-27,24,1479,0.6,1
1563,-21,0,1542,0.61,1
1432,5,24,1461,0.39,0
1564,4,0,1568,0.69,0
1430,-23,24,1431,0.31,0
1563,-14,-4,1545,0.62,1
1432,3,26,1461,0.38,0
1540,-5,0,1535,0.62,0
1433,-6,24,1451,0.38,0
1542,-24,0,1518,0.61,0
1431,-14,24,1441,0.39,1
1545,33,-4,1574,0.67,0
1428,-1,21,1448,0.33,1
1429,37,0,1466,0.38,0
1498,28,24,1550,0.62,0
1429,0,0,1429,0.39,0
1498,-18,24,1504,0.61,0
1427,-8,0,1419,0.35,0
1499,2,24,1525,0.65,0
1428,-3,-4,1421,0.33,1
1499,19,24,1542,0.67,1
1429,-1,0,1428,0.26,0
1588,-4,24,1608,0.74,1
1429,36,0,1465,0.35,0
1588,-38,24,1574,0.65,0
1430,0,-3,1427,0.27,1
1587,-7,24,1604,0.73,1
1429,-10,0,1419,0.4,1
1451,11,24,1486,0.6,0
1427,-15,0,1412,0.4,1
1452,4,24,1480,0.6,1
1428,2,-4,1426,0.43,0
1451,3,23,1477,0.57,0
1496,20,0,1516,0.55,0
1429,31,24,1484,0.45,0
1493,-9,0,1484,0.53,1
1432,8,24,1464,0.47,0
1491,1,-1,1491,0.56,1
1434,-12,26,1448,0.44,0
1451,12,0,1463,0.54,0
1432,-20,24,1436,0.46,1
1450,1,0,1451,0.49,0
1433,-1,24,1456,0.51,0
1447,-6,1,1442,0.43,1
1436,37,20,1493,0.57,0
1434,7,0,1441,0.35,1
1540,-12,24,1552,0.65,0
1436,-7,0,1429,0.37,0
1538,-39,24,1523,0.63,1
1437,-13,-1,1423,0.31,0
1537,4,22,1563,0.69,1
1438,-4,0,1434,0.36,0
1503,5,24,1532,0.64,1
1436,38,0,1474,0.43,1
1506,-10,24,1520,0.57,1
1436,-1,0,1435,0.36,0
1505,9,24,1538,0.64,0
1438,-7,-3,1428,0.39,1
1504,-24,24,1504,0.61,1
1440,-11,0,1429,0.32,0
1544,-5,24,1563,0.68,1
1440,-3,-2,1435,0.34,0
1543,-12,23,1554,0.66,0
1532,-13,0,1519,0.52,1
1442,40,24,1506,0.48,0
1530,3,0,1533,0.59,1
1444,1,24,1469,0.41,0
1528,7,-2,1533,0.6,1
1446,-7,26,1465,0.4,0
1552,38,0,1590,0.67,1
1447,-5,24,1466,0.33,1
1551,3,0,1554,0.56,0
1448,39,24,1511,0.44,0
1549,-3,-3,1543,0.6,1
1449,1,24,1474,0.4,0
1481,12,0,1493,0.53,1
1448,-3,24,1469,0.47,1
1478,-13,0,1465,0.51,1
1451,-15,24,1460,0.49,1
1476,9,0,1485,0.52,1
1452,-8,24,1468,0.48,1
1474,13,-2,1485,0.46,1
1454,35,21,1510,0.54,0
1452,-2,0,1450,0.37,1
1491,29,24,1544,0.63,0
1451,0,0,1451,0.42,1
1492,-8,24,1508,0.58,1
1451,-4,-3,1444,0.4,1
1492,3,20,1515,0.6,1
1452,-8,0,1444,0.34,0
1530,3,24,1557,0.66,1
1453,34,0,1487,0.41,0
1529,0,24,1553,0.59,1
1452,-5,0,1447,0.37,1
1531,-12,23,1542,0.63,0
1517,15,0,1532,0.6,1
1454,-15,24,1463,0.4,1
1519,-13,0,1506,0.55,0
1452,-3,24,1473,0.45,1
1518,-9,-4,1505,0.55,0
1453,-4,24,1473,0.45,0
1535,0,0,1535,0.54,1
1455,32,24,1511,0.46,0
1533,-7,0,1526,0.61,1
1457,-32,24,1449,0.39,0
1534,-22,0,1512,0.56,0
1456,-9,24,1471,0.44,1
1533,-21,0,1512,0.58,0
1457,-19,20,1458,0.42,0
1456,-3,0,1453,0.48,1
1458,-17,24,1465,0.52,0
1452,-12,0,1440,0.46,1
1461,-18,24,1467,0.54,0
1450,-12,-4,1434,0.46,1
1463,-20,20,1463,0.54,0
1460,2,-4,1458,0.43,1
1453,36,20,1509,0.57,0
1452,-12,-3,1437,0.42,0
1461,8,21,1490,0.58,0
1452,-18,0,1434,0.35,0
1523,-7,24,1540,0.65,1
1453,-4,0,1449,0.35,0
1522,12,24,1558,0.65,0
1454,-11,-2,1441,0.37,0
1521,-6,21,1536,0.63,0
1528,12,0,1540,0.54,0
1455,35,24,1514,0.46,0
1527,-14,0,1513,0.56,1
1457,-10,24,1471,0.44,1
1525,14,-4,1535,0.59,1
1458,-10,24,1472,0.41,0
1494,-1,0,1493,0.51,1
1460,0,24,1484,0.49,0
1493,33,0,1526,0.57,0
1462,-8,24,1478,0.43,0
1491,-15,-2,1474,0.42,1
1463,38,25,1526,0.58,1
1461,-16,0,1445,0.38,0
1534,-26,24,1532,0.62,0
1463,-7,1,1457,0.34,0
1533,23,20,1576,0.66,1
1467,-9,0,1458,0.48,0
1461,-12,24,1473,0.52,0
1465,-8,0,1457,0.41,0
1463,37,24,1524,0.59,0
1462,-9,-3,1450,0.48,1
1466,-24,24,1466,0.52,0
1430,-1,0,1429,0.44,1
1465,-18,24,1471,0.56,1
1428,0,0,1428,0.43,0
1466,-12,24,1478,0.57,0
1429,10,0,1439,0.44,0
1465,-12,24,1477,0.56,0
1430,-31,-4,1395,0.33,0
1464,36,20,1520,0.67,1
1465,-21,0,1444,0.29,0
1550,22,24,1596,0.71,1
1463,-20,0,1443,0.33,1
1552,-14,24,1562,0.67,1
1464,-11,-3,1450,0.35,0
1551,-16,22,1557,0.65,1
1462,-13,0,1449,0.39,1
1528,-26,24,1526,0.61,0
1460,36,0,1496,0.39,1
1530,16,24,1570,0.61,0
1461,-10,0,1451,0.38,1
1529,-19,24,1534,0.62,1
1455,-26,-3,1426,0.34,1
1534,-15,24,1543,0.66,0
1453,-17,0,1436,0.37,1
1525,-21,24,1528,0.63,0
1454,-10,0,1444,0.37,0
1524,-13,24,1535,0.63,1
1456,38,-4,1490,0.42,1
1522,1,24,1547,0.58,1
1452,-12,0,1440,0.33,0
1539,-3,24,1560,0.67,1
1452,-3,0,1449,0.38,1
1538,-25,24,1537,0.62,1
1454,8,0,1462,0.33,0
1536,28,24,1588,0.67,1
1452,3,-3,1452,0.33,0
1538,16,24,1578,0.67,0
1533,33,0,1566,0.51,0
1536,-2,24,1558,0.49,1
1534,-37,-3,1494,0.42,0
1535,-4,22,1553,0.58,1
1536,-23,0,1513,0.45,1
1510,10,24,1544,0.55,1
1537,29,0,1566,0.51,0
1509,29,24,1562,0.49,0
1539,-1,0,1538,0.52,0
1507,-10,24,1521,0.48,1
1541,-25,-3,1513,0.48,0
1505,-1,23,1527,0.52,1
1540,-5,0,1535,0.62,0
1433,-6,24,1451,0.38,0
1542,-24,0,1518,0.61,0
1431,-14,24,1441,0.39,1
1545,33,-4,1574,0.67,0
1428,-1,21,1448,0.33,1
1527,-8,0,1519,0.43,1
1547,0,24,1571,0.57,0
1524,0,0,1524,0.46,1
1550,-24,24,1550,0.54,1
1522,33,0,1555,0.45,1
1552,15,24,1591,0.55,0
1524,5,0,1529,0.45,0
1550,-9,24,1565,0.55,1
1526,3,-3,1526,0.48,0
1548,-32,24,1540,0.52,1
1543,12,0,1555,0.43,1
1549,30,24,1603,0.57,1
1544,-3,0,1541,0.46,1
1548,-2,24,1570,0.54,1
1546,-35,-2,1509,0.4,0
1547,11,22,1580,0.6,1
1550,1,0,1551,0.55,0
1532,-40,24,1516,0.45,1
1551,-29,0,1522,0.39,1
1532,42,24,1598,0.61,1
1549,29,1,1579,0.56,1
1534,-18,24,1540,0.44,1
1547,-7,0,1540,0.48,1
1527,5,24,1556,0.52,1
1548,8,0,1556,0.49,1
1526,14,24,1564,0.51,1
1549,8,-2,1555,0.48,1
1525,22,21,1568,0.52,1
1589,3,0,1592,0.57,1
1547,-29,24,1542,0.43,1
1587,-4,0,1583,0.47,1
1549,29,24,1602,0.53,0
1584,-5,-2,1577,0.51,1
1553,-8,24,1569,0.49,0
1442,24,0,1466,0.32,1
1557,12,24,1593,0.68,0
1442,-11,0,1431,0.29,1
1556,5,24,1585,0.71,1
1441,1,0,1442,0.34,1
1558,-27,24,1555,0.66,1
1442,-8,-3,1431,0.27,0
1556,24,22,1602,0.73,1
1554,-14,0,1540,0.54,1
1464,22,24,1510,0.46,0
1556,14,0,1570,0.64,0
1462,-18,24,1468,0.36,0
1554,2,-1,1555,0.64,1
1464,-32,24,1456,0.36,0
1556,-21,0,1535,0.57,1
1446,15,24,1485,0.43,1
1555,25,0,1580,0.64,1
1447,8,24,1479,0.36,0
1552,-18,-3,1531,0.59,1
1450,-2,24,1472,0.41,0
1517,11,0,1528,0.4,1
1554,20,24,1598,0.6,1
1520,-14,0,1506,0.4,0
1552,-3,24,1573,0.6,1
1517,-28,-2,1487,0.4,1
1555,-18,24,1561,0.6,0
1521,-12,0,1509,0.37,0
1553,24,24,1601,0.63,1
1523,22,0,1545,0.48,0
1551,-18,24,1557,0.52,1
1524,24,0,1548,0.43,1
1550,22,22,1594,0.57,1
1549,3,0,1552,0.49,1
1525,7,24,1556,0.51,1
1548,-20,0,1528,0.46,1
1526,5,24,1555,0.54,1
1547,23,0,1570,0.55,1
1527,-18,24,1533,0.45,0
1545,-21,-2,1522,0.42,1
1529,25,24,1578,0.58,0
1543,18,0,1561,0.55,1
1513,-15,24,1522,0.45,0
1545,3,-3,1545,0.49,0
1511,17,21,1549,0.51,1
1478,-7,0,1471,0.39,0
1546,-21,24,1549,0.61,0
1479,-11,0,1468,0.33,0
1545,22,24,1591,0.67,0
1479,29,-2,1506,0.44,0
1545,-22,26,1549,0.56,0
1495,0,0,1495,0.36,1
1547,21,24,1592,0.64,0
1496,13,0,1509,0.41,0
1546,2,24,1572,0.59,0
1498,0,-2,1496,0.43,0
1544,-24,21,1541,0.57,1
1546,24,0,1570,0.54,0
1528,-10,24,1542,0.46,0
1544,-22,0,1522,0.48,1
1530,-17,24,1537,0.52,0
1546,23,-1,1568,0.5,0
1528,17,22,1567,0.5,1
1547,5,0,1552,0.45,0
1566,-3,24,1587,0.55,1
1548,-27,0,1521,0.4,1
1565,-1,24,1588,0.6,1
1549,25,0,1574,0.61,0
1498,-26,24,1496,0.39,1
1552,-15,0,1537,0.52,0
1495,5,24,1524,0.48,1
1550,21,2,1573,0.52,1
1497,32,26,1555,0.48,0
1551,11,-2,1560,0.59,1
1496,-20,24,1500,0.41,1
1567,1,0,1568,0.54,0
1550,-32,24,1542,0.46,0
1564,-5,0,1559,0.44,1
1553,23,24,1600,0.56,0
1563,-4,-3,1556,0.49,0
1554,-14,24,1564,0.51,0
1540,-8,0,1532,0.41,0
1553,19,24,1596,0.59,0
1541,-3,0,1538,0.43,0
1552,13,24,1589,0.57,0
1539,-5,-3,1531,0.47,1
1555,-29,24,1550,0.53,1
1527,-20,0,1507,0.37,0
1554,19,24,1597,0.63,0
1525,-11,0,1514,0.43,1
1557,-16,24,1565,0.57,0
1525,-18,0,1507,0.37,1
1556,16,24,1596,0.63,1
1527,13,-3,1537,0.43,0
1554,13,21,1588,0.57,1
1555,-24,0,1531,0.46,1
1537,0,24,1561,0.54,1
1554,21,0,1575,0.52,0
1538,-3,24,1559,0.48,0
1553,-15,-4,1534,0.39,1
1540,47,26,1613,0.61,0
1552,12,0,1564,0.5,0
1529,11,24,1564,0.5,0
1550,12,0,1562,0.53,1
1531,-13,24,1542,0.47,0
1551,-25,0,1526,0.44,0
1530,13,24,1567,0.56,0
1465,-21,0,1444,0.29,0
1550,22,24,1596,0.71,1
1463,-20,0,1443,0.33,1
1552,-14,24,1562,0.67,1
1464,-11,-3,1450,0.35,0
1551,-16,22,1557,0.65,1
1553,11,0,1564,0.47,0
1553,5,24,1582,0.53,0
1551,16,0,1567,0.46,1
1555,18,24,1597,0.54,1
1553,-23,0,1530,0.44,0
1553,-8,24,1569,0.56,1
1551,19,-2,1568,0.48,0
1555,-1,24,1578,0.52,0
1466,-13,0,1453,0.34,1
1555,-9,24,1570,0.66,1
1466,13,0,1479,0.35,0
1554,11,24,1589,0.65,1
1467,18,-3,1482,0.34,1
1553,22,24,1599,0.66,1
1562,7,0,1569,0.65,0
1437,1,24,1462,0.35,1
1561,27,0,1588,0.66,1
1438,7,24,1469,0.34,0
1559,-18,0,1541,0.62,1
1439,-8,24,1455,0.38,1
1559,-16,-3,1540,0.59,1
1440,13,24,1477,0.41,1
1544,4,0,1548,0.43,1
1561,11,24,1596,0.57,0
1545,-21,0,1524,0.41,0
1560,6,24,1590,0.59,1
1543,41,-3,1581,0.45,1
1561,29,24,1614,0.55,0
1443,5,0,1448,0.34,0
1561,-20,24,1565,0.66,1
1443,-8,0,1435,0.32,0
1560,-16,24,1568,0.68,1
1445,7,-3,1449,0.31,0
1559,10,24,1593,0.69,1
1510,-21,0,1489,0.37,0
1560,-3,24,1581,0.63,0
1512,25,0,1537,0.39,0
1559,29,24,1612,0.61,0
1514,-3,0,1511,0.43,0
1557,-19,24,1562,0.57,1
1515,0,-3,1512,0.43,0
1555,-15,22,1562,0.57,1
1557,6,0,1563,0.56,0
1464,31,24,1519,0.44,1
1555,-10,0,1545,0.55,1
1466,22,24,1512,0.45,0
1553,30,-2,1581,0.64,1
1468,-6,22,1484,0.36,0
1556,-10,0,1546,0.46,1
1528,26,24,1578,0.54,1
1554,-17,0,1537,0.49,1
1530,-12,24,1542,0.51,0
1553,7,-1,1559,0.47,1
1531,29,22,1582,0.53,0
1591,9,0,1600,0.56,1
1554,-19,24,1559,0.44,0
1592,-27,0,1565,0.44,0
1553,28,24,1605,0.56,1
1590,2,-2,1590,0.52,1
1554,-5,24,1573,0.48,0
1526,-8,0,1518,0.43,1
1554,-13,24,1565,0.57,1
1527,21,0,1548,0.45,0
1553,5,24,1582,0.55,1
1525,-6,0,1519,0.43,1
1554,-13,24,1565,0.57,1
1526,15,-2,1539,0.41,0
1554,24,21,1599,0.59,0
1552,-9,0,1543,0.58,1
1464,-3,24,1485,0.42,0
1554,-11,0,1543,0.58,0
1462,1,24,1487,0.42,1
1555,0,-1,1554,0.63,0
1461,-23,24,1462,0.37,0
1553,-17,0,1536,0.58,1
1455,2,24,1481,0.42,0
1551,28,0,1579,0.63,1
1457,5,24,1486,0.37,1
1550,-5,-3,1542,0.57,1
1458,10,24,1492,0.43,1
1438,6,0,1444,0.33,0
1549,-9,24,1564,0.67,1
1440,7,0,1447,0.33,1
1548,0,24,1572,0.67,1
1441,15,0,1456,0.37,0
1547,-25,24,1546,0.63,1
1441,-2,-2,1437,0.28,0
1546,29,24,1599,0.72,0
1440,-11,0,1429,0.32,0
1544,-5,24,1563,0.68,1
1440,-3,-2,1435,0.34,0
1543,-12,23,1554,0.66,0
1543,3,0,1546,0.61,1
1449,-9,24,1464,0.39,1
1541,-28,0,1513,0.55,1
1451,6,24,1481,0.45,0
1540,25,0,1565,0.63,0
1452,0,24,1476,0.37,0
1538,-1,-3,1534,0.59,1
1454,-3,24,1475,0.41,1
1536,-14,0,1522,0.55,1
1465,1,24,1490,0.45,0
1537,6,0,1543,0.6,1
1464,-17,24,1471,0.4,1
1539,-25,-4,1510,0.49,0
1462,30,24,1516,0.51,1
1491,-29,0,1462,0.33,0
1538,25,24,1587,0.67,1
1490,26,0,1516,0.48,1
1540,-32,24,1532,0.52,0
1491,-3,0,1488,0.39,1
1539,1,24,1564,0.61,1
1521,7,0,1528,0.47,1
1541,-17,24,1548,0.53,0
1522,-6,0,1516,0.42,1
1539,9,24,1572,0.58,1
1523,-12,0,1511,0.39,1
1539,24,24,1587,0.61,1
1521,27,-3,1545,0.51,1
1540,-27,21,1534,0.49,0
1542,1,0,1543,0.51,0
1492,22,24,1538,0.49,1
1541,-22,0,1519,0.55,1
1493,-31,24,1486,0.45,0
1539,11,-1,1549,0.54,1
1494,2,26,1522,0.46,0
1540,24,0,1564,0.44,1
1543,37,24,1604,0.56,1
1538,-32,0,1506,0.44,0
1545,-20,24,1549,0.56,0
1539,-1,-3,1535,0.45,0
1544,3,21,1568,0.55,0
1536,12,0,1548,0.51,1
1541,-25,24,1540,0.49,0
1537,2,0,1539,0.45,1
1540,9,24,1573,0.55,1
1534,-1,-2,1531,0.4,1
1543,30,26,1599,0.6,1
1519,12,0,1531,0.45,0
1542,2,24,1568,0.55,1
1517,-17,-1,1499,0.43,1
1544,-21,26,1549,0.57,1
1550,-38,0,1512,0.42,0
1542,5,24,1571,0.58,1
1551,36,0,1587,0.49,0
1541,27,24,1592,0.51,0
1549,-8,-3,1538,0.46,1
1543,0,23,1566,0.54,0
1540,3,0,1543,0.51,1
1535,-22,24,1537,0.49,0
1542,-20,0,1522,0.48,0
1533,-24,24,1533,0.52,0
1543,8,0,1551,0.54,1
1532,-31,24,1525,0.46,1
1542,26,-3,1565,0.5,1
1534,8,24,1566,0.5,0
1544,-18,0,1526,0.57,0
1465,-13,24,1476,0.43,1
1545,-32,0,1513,0.52,0
1463,10,24,1497,0.48,0
1544,-1,-3,1540,0.57,1
1465,-1,24,1488,0.43,0
1483,-1,0,1482,0.42,0
1542,-26,24,1540,0.58,1
1481,-25,0,1456,0.33,1
1545,12,24,1581,0.67,0
1482,12,-1,1493,0.36,0
1544,24,26,1594,0.64,0
1489,-26,0,1463,0.39,1
1545,-30,24,1539,0.61,1
1487,-21,0,1466,0.35,1
1547,1,24,1572,0.65,1
1489,1,-3,1487,0.43,0
1546,-34,22,1534,0.57,0
1547,16,0,1563,0.45,0
1587,-10,24,1601,0.55,1
1546,18,0,1564,0.42,0
1589,10,24,1623,0.58,0
1547,-17,-1,1529,0.36,1
1587,15,24,1626,0.64,1
1548,-29,0,1519,0.46,0
1531,-9,24,1546,0.54,0
1546,0,0,1546,0.55,1
1533,-44,24,1513,0.45,0
1544,-38,0,1506,0.46,1
1535,-28,24,1531,0.54,0
1548,22,-4,1566,0.51,0
1531,5,22,1558,0.49,1
1467,-10,0,1457,0.32,0
1550,17,24,1591,0.68,0
1470,-10,0,1460,0.39,1
1547,-30,24,1541,0.61,1
1465,-10,-3,1452,0.35,1
1552,-14,24,1562,0.65,0
1500,-12,0,1488,0.37,1
1554,2,24,1580,0.63,0
1501,-14,0,1487,0.44,0
1553,-49,24,1528,0.56,0
1501,-3,0,1498,0.36,1
1553,20,24,1597,0.64,1
1499,16,-2,1513,0.38,1
1555,19,24,1598,0.62,0
1532,-35,0,1497,0.41,1
1519,19,24,1562,0.59,1
1533,-10,0,1523,0.5,0
1518,-17,24,1525,0.5,0
1535,17,0,1552,0.53,1
1516,-7,24,1533,0.47,1
1534,47,-4,1577,0.51,0
1517,28,24,1569,0.49,0
1535,-36,0,1499,0.41,0
1521,15,24,1560,0.59,1
1533,-36,0,1497,0.43,1
1523,1,23,1547,0.57,0
1436,14,0,1450,0.36,1
1535,-9,24,1550,0.64,1
1435,7,0,1442,0.31,1
1536,17,24,1577,0.69,0
1435,6,-2,1439,0.38,0
1536,-38,26,1524,0.62,1
1468,-9,0,1459,0.3,0
1537,43,24,1604,0.7,0
1465,2,0,1467,0.4,1
1540,-28,24,1536,0.6,0
1467,1,-1,1467,0.38,0
1539,-13,22,1548,0.62,1
1538,16,0,1554,0.62,0
1436,8,24,1468,0.38,0
1540,-34,0,1506,0.6,1
1434,-21,24,1437,0.4,1
1537,43,0,1580,0.65,1
1437,10,24,1471,0.35,0
1538,-19,-3,1516,0.58,1
1436,6,22,1464,0.42,1
1537,-12,0,1525,0.46,1
1527,3,24,1554,0.54,0
1536,11,-1,1546,0.5,1
1529,-13,26,1542,0.5,0
1550,1,0,1551,0.55,0
1532,-40,24,1516,0.45,1
1551,-29,0,1522,0.39,1
1532,42,24,1598,0.61,1
1549,29,1,1579,0.56,1
1534,-18,24,1540,0.44,1
1519,6,0,1525,0.5,1
1532,-28,24,1528,0.5,1
1517,25,0,1542,0.49,1
1533,-11,24,1546,0.51,1
1516,11,0,1527,0.51,1
1535,-42,24,1517,0.49,0
1517,19,-3,1533,0.42,0
1534,37,22,1593,0.58,0
1533,-19,0,1514,0.52,1
1475,0,24,1499,0.48,0
1531,-28,0,1503,0.5,1
1477,5,24,1506,0.5,0
1530,-8,-3,1519,0.52,1
1478,4,22,1504,0.48,1
1530,-33,0,1497,0.43,1
1545,-22,24,1547,0.57,1
1528,36,0,1564,0.52,1
1547,-22,24,1549,0.48,0
1529,-18,0,1511,0.42,0
1546,-1,22,1567,0.58,1
1528,-30,0,1498,0.51,1
1460,8,24,1492,0.49,0
1529,-2,0,1527,0.58,1
1458,-9,24,1473,0.42,1
1532,-26,-3,1503,0.54,1
1455,-1,21,1475,0.46,1
1527,-12,0,1515,0.39,1
1535,33,24,1592,0.61,0
1524,12,0,1536,0.49,1
1538,-20,24,1542,0.51,0
1523,-10,-1,1512,0.47,0
1539,-36,26,1529,0.53,0
1542,18,0,1560,0.5,1
1541,-5,24,1560,0.5,1
1540,-2,0,1538,0.5,1
1543,-30,24,1537,0.5,0
1537,11,0,1548,0.41,1
1546,39,24,1609,0.59,0
1538,-2,-2,1534,0.48,1
1545,-22,23,1546,0.52,1
1546,-40,0,1506,0.52,0
1478,-10,24,1492,0.48,1
1547,-4,0,1543,0.58,1
1476,-9,24,1491,0.42,1
1546,-39,0,1507,0.52,0
1478,-6,24,1496,0.48,0
1545,-40,-2,1503,0.52,1
1479,-10,23,1492,0.48,1
1542,34,0,1576,0.53,1
1513,18,24,1555,0.47,0
1545,-15,0,1530,0.52,0
1511,-22,24,1513,0.48,1
1546,2,0,1548,0.52,0
1510,1,24,1535,0.48,1
1545,-3,-4,1538,0.46,1
1511,27,26,1564,0.54,0
1544,-45,0,1499,0.4,0
1544,-1,24,1567,0.6,0
1542,33,0,1575,0.5,1
1546,2,24,1572,0.5,0
1543,-17,-4,1522,0.5,0
1545,-45,22,1522,0.5,0
1458,-11,0,1447,0.32,1
1547,7,24,1578,0.68,0
1460,-9,0,1451,0.34,0
1546,-1,24,1569,0.66,1
1461,-6,-1,1454,0.35,0
1544,-8,26,1562,0.65,1
1540,24,0,1564,0.44,1
1543,37,24,1604,0.56,1
1538,-32,0,1506,0.44,0
1545,-20,24,1549,0.56,0
1539,-1,-3,1535,0.45,0
1544,3,21,1568,0.55,0
1542,4,0,1546,0.58,1
1493,-28,24,1489,0.42,0
1545,-3,0,1542,0.54,0
1491,1,24,1516,0.46,1
1544,38,-1,1581,0.57,0
1492,20,22,1534,0.43,0
1546,-15,0,1531,0.57,1
1473,-17,24,1480,0.43,1
1545,-1,0,1544,0.6,1
1474,-22,24,1476,0.4,1
1548,8,-2,1554,0.53,1
1472,36,24,1532,0.47,1
1550,-38,0,1512,0.42,0
1542,5,24,1571,0.58,1
1551,36,0,1587,0.49,0
1541,27,24,1592,0.51,0
1549,-8,-3,1538,0.46,1
1543,0,23,1566,0.54,0
1472,-6,0,1466,0.37,1
1548,-15,24,1557,0.63,1
1474,-13,0,1461,0.35,1
1545,-4,24,1565,0.65,1
1475,17,-1,1491,0.38,0
1544,6,26,1576,0.62,1
1477,14,0,1491,0.34,0
1546,35,24,1605,0.66,0
1479,-9,0,1470,0.38,0
1544,-12,24,1556,0.62,1
1482,2,-3,1481,0.41,0
1541,-17,22,1546,0.59,1
1540,-5,0,1535,0.6,0
1443,1,24,1468,0.4,0
1539,-42,0,1497,0.55,0
1444,-2,24,1466,0.45,0
1538,13,-2,1549,0.61,1
1445,-2,24,1467,0.39,1
1531,-26,-3,1502,0.37,1
1540,33,21,1594,0.63,0
1538,-14,0,1524,0.48,0
1514,2,24,1540,0.52,0
1537,-15,0,1522,0.44,1
1516,23,24,1563,0.56,0
1538,-5,-1,1532,0.49,0
1515,1,22,1538,0.51,1
1447,-7,0,1440,0.32,0
1537,12,24,1573,0.68,1
1447,1,0,1448,0.3,0
1537,35,24,1596,0.7,1
1449,18,-2,1465,0.39,0
1535,-14,24,1545,0.61,1
1506,0,0,1506,0.48,1
1534,-38,24,1520,0.52,1
1505,-8,0,1497,0.43,0
1535,-16,24,1543,0.57,0
1501,4,0,1505,0.41,1
1539,1,24,1564,0.59,0
1503,32,0,1535,0.45,0
1537,10,21,1568,0.55,1
1536,31,0,1567,0.63,1
1428,24,24,1476,0.37,0
1536,-12,0,1524,0.64,1
1429,-28,24,1425,0.36,1
1538,-15,-3,1520,0.61,0
1427,-8,21,1440,0.39,0
1537,4,0,1541,0.52,1
1484,19,24,1527,0.48,1
1540,16,2,1558,0.59,0
1480,-11,26,1495,0.41,1
1542,32,-1,1573,0.6,1
1479,-2,24,1501,0.4,1
1515,26,5,1546,0.58,1
1468,-8,29,1489,0.42,1
1470,-9,0,1461,0.36,0
1513,23,24,1560,0.64,1
1471,-5,-3,1463,0.42,0
1511,-17,24,1518,0.58,1
1595,-11,0,1584,0.57,1
1513,-1,24,1536,0.43,0
1595,15,0,1610,0.57,1
1514,26,24,1564,0.43,1
1596,-24,-2,1570,0.58,1
1513,-20,24,1517,0.42,1
1536,23,0,1559,0.51,0
1510,22,24,1556,0.49,1
1537,-43,0,1494,0.47,0
1509,-15,24,1518,0.53,1
1536,-24,0,1512,0.47,0
1510,-4,24,1530,0.53,0
1535,32,-3,1564,0.51,0
1512,25,22,1559,0.49,0
1510,-21,0,1489,0.37,0
1560,-3,24,1581,0.63,0
1512,25,0,1537,0.39,0
1559,29,24,1612,0.61,0
1514,-3,0,1511,0.43,0
1557,-19,24,1562,0.57,1
1515,0,-3,1512,0.43,0
1555,-15,22,1562,0.57,1
1517,26,0,1543,0.44,0
1531,30,24,1585,0.56,1
1515,-19,0,1496,0.44,1
1532,-15,24,1541,0.56,1
1517,24,-1,1540,0.54,0
1531,-44,24,1511,0.46,1
1493,42,0,1535,0.5,1
1518,-10,24,1532,0.5,0
1494,-33,0,1461,0.39,0
1517,0,24,1541,0.61,1
1497,15,-3,1509,0.43,0
1514,22,24,1560,0.57,1
1460,-6,0,1454,0.37,1
1516,9,24,1549,0.63,1
1461,-9,0,1452,0.35,0
1515,22,24,1561,0.65,1
1459,-4,-3,1452,0.38,0
1517,-6,22,1533,0.62,0
1519,6,0,1525,0.5,1
1532,-28,24,1528,0.5,1
1517,25,0,1542,0.49,1
1533,-11,24,1546,0.51,1
1516,11,0,1527,0.51,1
1535,-42,24,1517,0.49,0
1517,19,-3,1533,0.42,0
1534,37,22,1593,0.58,0
1518,-12,0,1506,0.41,1
1537,7,24,1568,0.59,1
1514,6,0,1520,0.48,1
1540,-33,24,1531,0.52,0
1515,26,-1,1540,0.48,1
1539,-5,24,1558,0.52,1
1434,13,0,1447,0.35,1
1517,15,24,1556,0.65,1
1436,-17,0,1419,0.31,0
1516,14,24,1554,0.69,1
1437,1,0,1438,0.39,0
1515,-24,24,1515,0.61,0
1438,-5,-2,1431,0.37,1
1514,-18,24,1520,0.63,1
1476,13,0,1489,0.41,1
1515,9,24,1548,0.59,1
1476,-1,0,1475,0.38,1
1514,25,24,1563,0.62,1
1478,28,-2,1504,0.48,0
1513,-17,21,1517,0.52,0
1514,10,0,1524,0.42,0
1532,26,24,1582,0.58,0
1516,-30,0,1486,0.39,0
1530,6,24,1560,0.61,1
1517,6,-1,1522,0.45,0
1529,1,26,1556,0.55,1
1516,28,0,1544,0.57,1
1477,-8,24,1493,0.43,0
1515,-16,0,1499,0.51,1
1479,-10,24,1493,0.49,1
1517,-28,0,1489,0.49,0
1477,-9,24,1492,0.51,1
1514,13,0,1527,0.5,1
1480,22,24,1526,0.5,1
1515,-17,-2,1496,0.5,1
1479,-7,24,1496,0.5,1
1539,0,0,1539,0.5,0
1513,0,24,1537,0.5,1
1540,1,0,1541,0.48,0
1512,22,24,1558,0.52,0
1542,-45,-4,1493,0.49,0
1511,-33,24,1502,0.51,1
1542,34,0,1576,0.53,1
1513,18,24,1555,0.47,0
1545,-15,0,1530,0.52,0
1511,-22,24,1513,0.48,1
1546,2,0,1548,0.52,0
1510,1,24,1535,0.48,1
1545,-3,-4,1538,0.46,1
1511,27,26,1564,0.54,0
1543,18,0,1561,0.55,1
1513,-15,24,1522,0.45,0
1545,3,-3,1545,0.49,0
1511,17,21,1549,0.51,1
1508,-10,0,1498,0.57,1
1436,-10,24,1450,0.43,1
1507,-19,0,1488,0.52,1
1437,12,24,1473,0.48,1
1506,25,-2,1529,0.59,1
1438,6,24,1468,0.41,0
1506,1,0,1507,0.41,1
1535,12,24,1571,0.59,1
1508,-16,0,1492,0.37,1
1533,31,24,1588,0.63,1
1507,-12,0,1495,0.45,1
1534,-27,24,1531,0.55,0
1508,17,-1,1524,0.52,0
1533,-45,26,1514,0.48,0
1528,28,0,1556,0.5,1
1505,24,24,1553,0.5,1
1529,-27,0,1502,0.47,0
1503,0,24,1527,0.53,1
1527,11,-2,1536,0.54,1
1506,-18,24,1512,0.46,0
1436,-7,0,1429,0.37,0
1507,-11,24,1520,0.63,0
1437,-23,0,1414,0.32,0
1505,16,24,1545,0.68,1
1436,-9,-3,1424,0.39,1
1507,-31,22,1498,0.61,0
1508,3,0,1511,0.49,0
1521,-27,24,1518,0.51,1
1510,-3,0,1507,0.43,1
1519,14,24,1557,0.57,1
1509,-25,0,1484,0.44,0
1520,-16,24,1528,0.56,0
1506,13,-4,1515,0.5,1
1523,-30,22,1515,0.5,0
1504,18,0,1522,0.57,1
1465,-13,24,1476,0.43,0
1506,4,-2,1508,0.52,0
1462,11,22,1495,0.48,1
1463,11,-2,1472,0.43,0
1505,-6,24,1523,0.57,0
1461,-33,0,1428,0.39,1
1504,-21,24,1507,0.61,1
1459,13,0,1472,0.4,0
1506,12,24,1542,0.6,0
1457,3,0,1460,0.37,1
1509,20,24,1553,0.63,0
1458,-14,-3,1441,0.37,0
1507,1,24,1532,0.63,1
1535,-18,0,1517,0.49,1
1505,-4,24,1525,0.51,1
1533,5,0,1538,0.54,0
1507,-19,24,1512,0.46,0
1532,29,-3,1558,0.53,1
1508,9,22,1539,0.47,0
1510,24,0,1534,0.56,0
1484,-16,24,1492,0.44,1
1508,-3,0,1505,0.47,1
1486,15,24,1525,0.53,0
1506,-4,-3,1499,0.49,1
1488,-5,22,1505,0.51,0
1508,-18,0,1490,0.45,0
1487,11,24,1522,0.55,1
1507,7,0,1514,0.48,0
1488,18,24,1530,0.52,0
1505,27,-1,1531,0.55,1
1490,-22,26,1494,0.45,0
1506,0,0,1506,0.48,1
1534,-38,24,1520,0.52,1
1505,-8,0,1497,0.43,0
1535,-16,24,1543,0.57,0
1501,4,0,1505,0.41,1
1539,1,24,1564,0.59,0
1503,32,0,1535,0.45,0
1537,10,21,1568,0.55,1
1468,-11,-2,1455,0.39,1
1502,4,26,1532,0.61,1
1443,0,0,1443,0.38,1
1505,-2,24,1527,0.62,1
1444,-5,2,1441,0.37,0
1503,3,26,1532,0.63,1
1446,2,-3,1445,0.35,0
1501,28,24,1553,0.65,1
1550,-20,0,1530,0.58,0
1459,-7,24,1476,0.42,0
1550,42,0,1592,0.66,1
1459,-4,24,1479,0.34,0
1549,1,2,1552,0.57,0
1460,18,26,1504,0.43,0
1546,-21,-3,1522,0.55,1
1463,1,24,1488,0.45,0
1466,-17,0,1449,0.43,1
1466,5,24,1495,0.57,0
1464,5,-1,1468,0.48,1
1467,-6,22,1483,0.52,0
1468,-2,0,1466,0.29,1
1595,5,24,1624,0.71,1
1469,15,0,1484,0.31,0
1594,6,24,1624,0.69,1
1469,-5,0,1464,0.31,0
1594,-15,24,1603,0.69,1
1470,-22,-4,1444,0.26,0
1593,13,24,1630,0.74,1
1468,-9,0,1459,0.3,0
1537,43,24,1604,0.7,0
1465,2,0,1467,0.4,1
1540,-28,24,1536,0.6,0
1467,1,-1,1467,0.38,0
1539,-13,22,1548,0.62,1
1542,-41,0,1501,0.52,1
1468,-3,24,1489,0.48,0
1543,-25,0,1518,0.56,0
1466,-12,24,1478,0.44,0
1544,-11,0,1533,0.57,1
1465,-7,24,1482,0.43,1
1471,6,0,1477,0.48,1
1462,1,24,1487,0.52,1
1473,-6,0,1467,0.48,0
1460,0,24,1484,0.52,1
1472,28,-2,1498,0.52,1
1461,-5,24,1480,0.48,0
1460,-6,0,1454,0.37,1
1516,9,24,1549,0.63,1
1461,-9,0,1452,0.35,0
1515,22,24,1561,0.65,1
1459,-4,-3,1452,0.38,0
1517,-6,22,1533,0.62,0
1460,3,0,1463,0.49,1
1438,5,24,1467,0.51,1
1457,-9,0,1448,0.5,1
1441,-16,24,1449,0.5,1
1459,-14,0,1445,0.46,0
1439,7,24,1470,0.54,1
1462,-10,-2,1450,0.48,0
1435,2,24,1461,0.52,1
1552,-9,0,1543,0.58,1
1464,-3,24,1485,0.42,0
1554,-11,0,1543,0.58,0
1462,1,24,1487,0.42,1
1555,0,-1,1554,0.63,0
1461,-23,24,1462,0.37,0
1552,19,0,1571,0.63,1
1462,-11,24,1475,0.37,1
1548,-65,0,1483,0.5,1
1466,-4,24,1486,0.5,1
1546,0,0,1546,0.58,1
1468,-6,24,1486,0.42,1
1544,3,-4,1543,0.58,1
1469,-3,21,1487,0.42,0
1471,-17,0,1454,0.3,1
1579,-1,24,1602,0.7,1
1473,-2,0,1471,0.33,0
1577,-8,24,1593,0.67,1
1474,4,3,1481,0.33,0
1577,4,21,1602,0.67,0
1476,-6,-1,1469,0.52,0
1440,-10,26,1456,0.48,1
1516,28,0,1544,0.57,1
1477,-8,24,1493,0.43,0
1515,-16,0,1499,0.51,1
1479,-10,24,1493,0.49,1
1517,-28,0,1489,0.49,0
1477,-9,24,1492,0.51,1
1514,13,0,1527,0.5,1
1480,22,24,1526,0.5,1
1515,-17,-2,1496,0.5,1
1479,-7,24,1496,0.5,1
1546,-40,0,1506,0.52,0
1478,-10,24,1492,0.48,1
1547,-4,0,1543,0.58,1
1476,-9,24,1491,0.42,1
1546,-39,0,1507,0.52,0
1478,-6,24,1496,0.48,0
1545,-40,-2,1503,0.52,1
1479,-10,23,1492,0.48,1
1479,19,0,1498,0.42,1
1523,10,24,1557,0.58,1
1477,-9,0,1468,0.4,1
1525,-12,26,1539,0.6,0
1481,0,0,1481,0.48,1
1475,-4,24,1495,0.52,1
1482,-7,0,1475,0.42,0
1474,31,24,1529,0.58,1
1479,17,0,1496,0.47,1
1477,18,24,1519,0.53,1
1477,-7,-2,1468,0.49,1
1479,-23,22,1478,0.51,1
1466,8,0,1474,0.46,1
1476,3,24,1503,0.54,1
1465,-1,0,1464,0.45,1
1478,-6,24,1496,0.55,1
1462,-14,0,1448,0.42,1
1480,1,24,1505,0.58,1
1461,31,-4,1488,0.45,0
1482,16,24,1522,0.55,0
1437,-11,0,1426,0.39,0
1483,-6,24,1501,0.61,0
1439,2,0,1441,0.44,0
1481,-18,24,1487,0.56,1
1442,-1,-2,1439,0.42,0
1478,-4,20,1494,0.58,1
1477,-10,0,1467,0.49,0
1465,-18,24,1471,0.51,0
1475,2,0,1477,0.45,1
1467,25,24,1516,0.55,0
1477,-2,0,1475,0.51,0
1466,-27,26,1465,0.49,1
1475,-14,0,1461,0.42,1
1536,-42,24,1518,0.58,1
1475,0,0,1475,0.35,1
1535,24,24,1583,0.65,1
1472,-6,-4,1462,0.38,1
1538,-12,24,1550,0.62,0
1594,10,0,1604,0.67,1
1474,-13,24,1485,0.33,0
1593,-30,0,1563,0.59,1
1475,3,24,1502,0.41,0
1591,10,1,1602,0.64,1
1477,0,29,1506,0.36,0
1529,24,0,1553,0.58,1
1478,-4,24,1498,0.42,0
1528,5,-1,1532,0.55,0
1479,-8,25,1496,0.45,0
1477,14,0,1491,0.34,0
1546,35,24,1605,0.66,0
1479,-9,0,1470,0.38,0
1544,-12,24,1556,0.62,1
1482,2,-3,1481,0.41,0
1541,-17,22,1546,0.59,1
1483,-1,0,1482,0.42,0
1542,-26,24,1540,0.58,1
1481,-25,0,1456,0.33,1
1545,12,24,1581,0.67,0
1482,12,-1,1493,0.36,0
1544,24,26,1594,0.64,0
1444,3,0,1447,0.42,1
1483,-7,24,1500,0.58,0
1449,11,0,1460,0.44,0
1478,-3,24,1499,0.56,1
1447,-2,0,1445,0.41,1
1480,2,24,1506,0.59,0
1446,0,-1,1445,0.45,1
1481,-26,24,1479,0.55,0
1526,10,0,1536,0.52,1
1483,18,24,1525,0.48,0
1525,-11,0,1514,0.51,1
1484,-1,24,1507,0.49,1
1527,16,-1,1542,0.56,0
1483,-7,21,1497,0.44,1
1482,-4,0,1478,0.48,1
1471,-5,24,1490,0.52,1
1483,-22,0,1461,0.44,1
1470,6,24,1500,0.56,1
1484,19,0,1503,0.49,1
1469,21,24,1514,0.51,1
1482,-5,-3,1474,0.46,1
1470,6,23,1499,0.54,0
1484,-2,0,1482,0.49,0
1445,19,24,1488,0.51,1
1483,-9,0,1474,0.51,0
1446,-4,23,1465,0.49,0
1537,4,0,1541,0.52,1
1484,19,24,1527,0.48,1
1540,16,2,1558,0.59,0
1480,-11,26,1495,0.41,1
1542,32,-1,1573,0.6,1
1479,-2,24,1501,0.4,1
1459,22,0,1481,0.37,0
1529,21,24,1574,0.63,0
1460,-6,0,1454,0.37,0
1528,-3,24,1549,0.63,1
1461,0,0,1461,0.36,0
1527,15,21,1563,0.64,1
1462,18,0,1480,0.41,0
1516,0,24,1540,0.59,1
1464,-36,0,1428,0.32,0
1514,19,24,1557,0.68,1
1463,18,-3,1478,0.44,1
1515,-16,22,1521,0.56,0
1455,2,0,1457,0.47,0
1464,-14,24,1474,0.53,0
1457,12,0,1469,0.48,0
1461,-2,24,1483,0.52,1
1456,3,0,1459,0.43,1
1463,20,24,1507,0.57,1
1455,-9,-2,1444,0.49,1
1464,-38,24,1450,0.51,0
1510,-13,0,1497,0.49,1
1465,17,24,1506,0.51,1
1512,-14,0,1498,0.54,0
1463,-16,24,1471,0.46,1
1515,27,-3,1539,0.58,0
1460,-2,21,1479,0.42,1
1461,21,0,1482,0.5,1
1456,5,24,1485,0.5,1
1463,-36,0,1427,0.44,1
1454,-10,24,1468,0.56,1
1460,15,-1,1474,0.48,1
1457,4,26,1487,0.52,0
1543,19,0,1562,0.61,1
1462,-3,24,1483,0.39,0
1544,-1,0,1543,0.54,1
1461,26,26,1513,0.46,1
1458,1,0,1459,0.52,1
1459,-35,24,1448,0.48,1
1456,-15,0,1441,0.45,1
1460,-8,24,1476,0.55,0
1453,-20,-2,1431,0.4,1
1463,16,24,1503,0.6,0
1464,-1,0,1463,0.32,1
1548,21,24,1593,0.68,1
1465,24,0,1489,0.39,0
1547,-2,24,1569,0.61,0
1466,-8,-2,1456,0.33,0
1546,11,21,1578,0.67,1
1522,-3,0,1519,0.53,0
1463,11,24,1498,0.47,1
1518,-18,0,1500,0.51,1
1467,-1,24,1490,0.49,0
1521,6,-1,1526,0.55,0
1464,-1,26,1489,0.45,1
1479,26,0,1505,0.5,1
1463,20,24,1507,0.5,1
1478,13,0,1491,0.52,1
1464,-12,24,1476,0.48,0
1477,2,-3,1476,0.47,1
1465,14,20,1499,0.53,1
1460,-12,0,1448,0.36,1
1532,-9,24,1547,0.64,0
1461,1,0,1462,0.33,0
1531,27,24,1582,0.67,1
1462,28,-2,1488,0.43,1
1530,-13,21,1538,0.57,1
1461,-17,0,1444,0.4,1
1479,11,24,1514,0.6,1
1458,9,0,1467,0.44,1
1482,5,24,1511,0.56,0
1460,-4,0,1456,0.42,1
1480,7,24,1511,0.58,1
1462,2,-2,1462,0.46,0
1478,-12,24,1490,0.54,1
1464,28,0,1492,0.53,0
1443,5,24,1472,0.47,0
1465,-24,0,1441,0.45,0
1442,11,24,1477,0.55,0
1463,10,-2,1471,0.5,1
1443,5,22,1470,0.5,1
1536,-14,0,1522,0.55,1
1465,1,24,1490,0.45,0
1537,6,0,1543,0.6,1
1464,-17,24,1471,0.4,1
1539,-25,-4,1510,0.49,0
1462,30,24,1516,0.51,1
1599,-22,0,1577,0.66,0
1463,-27,24,1460,0.34,0
1598,0,0,1598,0.64,0
1464,11,24,1499,0.36,0
1597,-34,0,1563,0.6,1
1465,4,24,1493,0.4,1
1594,-38,-4,1552,0.6,1
1468,-12,26,1482,0.4,0
1454,-5,0,1449,0.39,1
1467,34,24,1525,0.61,1
1456,12,-3,1465,0.51,1
1465,-24,20,1461,0.49,1
1466,8,0,1474,0.46,1
1476,3,24,1503,0.54,1
1465,-1,0,1464,0.45,1
1478,-6,24,1496,0.55,1
1462,-14,0,1448,0.42,1
1480,1,24,1505,0.58,1
1461,31,-4,1488,0.45,0
1482,16,24,1522,0.55,0
1461,-22,0,1439,0.25,0
1590,12,24,1626,0.75,1
1463,16,0,1479,0.35,0
1588,-29,24,1583,0.65,1
1464,-2,0,1462,0.33,1
1587,-30,24,1581,0.67,1
1464,-4,-2,1458,0.3,1
1587,-2,24,1609,0.7,1
1477,-10,0,1467,0.49,0
1465,-18,24,1471,0.51,0
1475,2,0,1477,0.45,1
1467,25,24,1516,0.55,0
1477,-2,0,1475,0.51,0
1466,-27,26,1465,0.49,1
1489,16,0,1505,0.49,1
1469,18,24,1511,0.51,0
1491,-18,0,1473,0.48,0
1467,-4,24,1487,0.52,1
1492,-27,-2,1463,0.49,0
1466,-19,24,1471,0.51,1
1468,1,0,1469,0.44,0
1464,22,24,1510,0.56,1
1467,6,0,1473,0.52,1
1466,-32,24,1458,0.48,0
1468,-1,-3,1464,0.44,0
1464,17,22,1503,0.56,1
1463,1,0,1464,0.46,1
1492,-23,24,1493,0.54,1
1462,-23,0,1439,0.38,1
1494,5,24,1523,0.62,1
1460,23,-3,1480,0.42,1
1495,18,24,1537,0.58,1
1461,-33,0,1428,0.39,1
1504,-21,24,1507,0.61,1
1459,13,0,1472,0.4,0
1506,12,24,1542,0.6,0
1457,3,0,1460,0.37,1
1509,20,24,1553,0.63,0
1458,-14,-3,1441,0.37,0
1507,1,24,1532,0.63,1
1591,4,0,1595,0.63,0
1457,20,24,1501,0.37,0
1593,-8,0,1585,0.69,0
1455,-32,24,1447,0.31,1
1592,6,-2,1596,0.64,1
1456,14,24,1494,0.36,0
1530,-28,0,1502,0.53,1
1458,1,24,1483,0.47,0
1532,-45,0,1487,0.54,0
1456,-17,24,1463,0.46,1
1531,-34,-4,1493,0.5,1
1457,19,20,1496,0.5,1
1455,-34,0,1421,0.41,1
1466,-5,24,1485,0.59,0
1452,14,0,1466,0.48,1
1470,-12,24,1482,0.52,0
1453,1,0,1454,0.47,0
1469,-17,24,1476,0.53,0
1455,3,0,1458,0.46,0
1467,-3,24,1488,0.54,1
1457,-18,0,1439,0.39,0
1527,-36,24,1515,0.61,1
1455,21,0,1476,0.43,0
1528,-24,24,1528,0.57,0
1457,-28,-2,1427,0.32,0
1527,9,25,1561,0.68,1
1548,-5,0,1543,0.57,0
1456,12,24,1492,0.43,0
1548,-5,0,1543,0.58,0
1457,3,26,1486,0.42,0
1533,5,0,1538,0.61,1
1458,-23,24,1459,0.39,1
1531,2,0,1533,0.61,1
1459,-29,24,1454,0.39,0
1530,1,0,1531,0.55,0
1461,11,24,1496,0.45,0
1531,-1,-2,1528,0.56,0
1459,3,24,1486,0.44,1
1521,25,5,1551,0.44,1
1601,-35,30,1596,0.56,1
1599,0,0,1599,0.65,1
1497,-28,24,1493,0.35,0
1597,12,-4,1605,0.61,1
1499,5,24,1528,0.39,0
1595,-11,0,1584,0.57,1
1513,-1,24,1536,0.43,0
1595,15,0,1610,0.57,1
1514,26,24,1564,0.43,1
1596,-24,-2,1570,0.58,1
1513,-20,24,1517,0.42,1
1468,-2,0,1466,0.29,1
1595,5,24,1624,0.71,1
1469,15,0,1484,0.31,0
1594,6,24,1624,0.69,1
1469,-5,0,1464,0.31,0
1594,-15,24,1603,0.69,1
1470,-22,-4,1444,0.26,0
1593,13,24,1630,0.74,1
1455,-26,0,1429,0.29,0
1593,-29,24,1588,0.71,0
1456,2,0,1458,0.33,0
1592,-33,24,1583,0.67,1
1457,13,-3,1467,0.29,0
1591,6,24,1621,0.71,1
1540,-18,0,1522,0.36,1
1593,4,24,1621,0.64,0
1542,12,0,1554,0.43,0
1591,-15,24,1600,0.57,1
1543,-5,0,1538,0.38,0
1590,12,24,1626,0.62,1
1544,17,-2,1559,0.47,0
1588,-28,21,1581,0.53,0
1587,8,0,1595,0.65,1
1458,3,24,1485,0.35,1
1589,11,0,1600,0.65,1
1456,11,24,1491,0.35,1
1592,-14,-3,1575,0.65,0
1453,-6,21,1468,0.35,1
1591,9,0,1600,0.56,1
1554,-19,24,1559,0.44,0
1592,-27,0,1565,0.44,0
1553,28,24,1605,0.56,1
1590,2,-2,1590,0.52,1
1554,-5,24,1573,0.48,0
1589,11,0,1600,0.64,1
1470,3,24,1497,0.36,1
1587,-11,0,1576,0.58,1
1471,28,24,1523,0.42,1
1586,10,-2,1594,0.6,1
1473,22,26,1521,0.4,0
1507,30,0,1537,0.41,1
1587,-14,24,1597,0.59,0
1509,5,0,1514,0.37,0
1586,0,24,1610,0.63,1
1507,-12,-3,1492,0.32,0
1587,11,26,1624,0.68,0
1509,-6,0,1503,0.37,0
1586,-17,24,1593,0.63,1
1510,2,1,1513,0.35,0
1585,9,24,1618,0.65,0
1587,0,0,1587,0.54,0
1523,12,24,1559,0.46,0
1588,15,0,1603,0.62,0
1521,-23,24,1522,0.38,0
1591,-5,-4,1582,0.58,0
1519,-16,24,1527,0.42,1
1590,-14,0,1576,0.53,1
1521,14,24,1559,0.47,1
1588,6,0,1594,0.58,1
1522,-11,24,1535,0.42,0
1590,-33,-2,1555,0.49,0
1520,16,23,1559,0.51,1
1546,-32,0,1514,0.36,1
1592,0,24,1616,0.64,1
1543,-23,0,1520,0.36,1
1595,2,24,1621,0.64,1
1545,5,0,1550,0.43,0
1593,-18,24,1599,0.57,1
1546,-18,-4,1524,0.37,0
1592,3,24,1619,0.63,0
1440,10,0,1450,0.31,1
1595,-33,24,1586,0.69,1
1437,-10,0,1427,0.24,1
1598,3,24,1625,0.76,0
1435,4,-1,1438,0.25,1
1600,5,22,1627,0.75,1
1599,-22,0,1577,0.66,0
1463,-27,24,1460,0.34,0
1598,0,0,1598,0.64,0
1464,11,24,1499,0.36,0
1597,-34,0,1563,0.6,1
1465,4,24,1493,0.4,1
1594,-38,-4,1552,0.6,1
1468,-12,26,1482,0.4,0
1596,2,0,1598,0.66,0
1459,-1,24,1482,0.34,0
1595,8,0,1603,0.66,1
1460,4,24,1488,0.34,1
1592,-28,-2,1562,0.62,1
1462,-7,21,1476,0.38,0
1594,-1,0,1593,0.59,0
1520,-16,24,1528,0.41,1
1592,-34,0,1558,0.51,1
1521,8,24,1553,0.49,1
1591,0,-2,1589,0.57,1
1523,-4,24,1543,0.43,0
1461,-22,0,1439,0.25,0
1590,12,24,1626,0.75,1
1463,16,0,1479,0.35,0
1588,-29,24,1583,0.65,1
1464,-2,0,1462,0.33,1
1587,-30,24,1581,0.67,1
1464,-4,-2,1458,0.3,1
1587,-2,24,1609,0.7,1
1525,8,0,1533,0.44,1
1586,-32,24,1578,0.56,1
1522,-2,0,1520,0.36,1
1589,6,24,1619,0.64,0
1520,-5,0,1515,0.34,1
1591,14,24,1629,0.66,1
1518,26,-3,1541,0.44,1
1593,-29,20,1584,0.56,1
1595,-37,0,1558,0.63,0
1441,-2,24,1463,0.37,1
1593,-9,0,1584,0.67,1
1443,-6,24,1461,0.33,0
1596,6,-2,1600,0.68,0
1440,3,22,1465,0.32,1
1594,10,0,1604,0.67,1
1474,-13,24,1485,0.33,0
1593,-30,0,1563,0.59,1
1475,3,24,1502,0.41,0
1591,10,1,1602,0.64,1
1477,0,29,1506,0.36,0
1525,-7,0,1518,0.38,0
1589,-10,24,1603,0.62,1
1526,28,0,1554,0.41,0
1588,5,26,1619,0.59,0
1467,10,0,1477,0.3,0
1587,12,24,1623,0.7,1
1464,-17,0,1447,0.26,1
1590,10,24,1624,0.74,0
1465,-8,-4,1453,0.32,0
1589,-30,24,1583,0.68,1
1591,4,0,1595,0.63,0
1457,20,24,1501,0.37,0
1593,-8,0,1585,0.69,0
1455,-32,24,1447,0.31,1
1592,6,-2,1596,0.64,1
1456,14,24,1494,0.36,0
1589,12,0,1601,0.55,1
1537,8,24,1569,0.45,0
1590,-27,0,1563,0.51,0
1535,-6,24,1553,0.49,0
1589,4,1,1594,0.61,1
1537,-49,26,1514,0.39,0
1547,16,0,1563,0.45,0
1587,-10,24,1601,0.55,1
1546,18,0,1564,0.42,0
1589,10,24,1623,0.58,0
1547,-17,-1,1529,0.36,1
1587,15,24,1626,0.64,1
1494,18,0,1512,0.38,0
1585,-15,24,1594,0.62,1
1495,-10,0,1485,0.33,0
1584,2,24,1610,0.67,1
1496,-12,0,1484,0.34,0
1584,-9,24,1599,0.66,0
1497,-15,-4,1478,0.31,0
1582,13,20,1615,0.69,1
1580,9,0,1589,0.59,1
1513,-9,24,1528,0.41,0
1578,-16,-1,1561,0.53,1
1515,0,24,1539,0.47,0
1581,10,0,1591,0.63,1
1465,8,24,1497,0.37,1
1582,-9,0,1573,0.6,0
1463,15,24,1502,0.4,0
1581,13,-3,1591,0.63,1
1464,7,24,1495,0.37,0
1521,25,5,1551,0.44,1
1601,-35,30,1596,0.56,1
1532,-35,0,1497,0.41,1
1519,19,24,1562,0.59,1
1533,-10,0,1523,0.5,0
1518,-17,24,1525,0.5,0
1535,17,0,1552,0.53,1
1516,-7,24,1533,0.47,1
1534,47,-4,1577,0.51,0
1517,28,24,1569,0.49,0
1462,18,0,1480,0.41,0
1516,0,24,1540,0.59,1
1464,-36,0,1428,0.32,0
1514,19,24,1557,0.68,1
1463,18,-3,1478,0.44,1
1515,-16,22,1521,0.56,0
1511,-12,0,1499,0.44,1
1536,-16,24,1544,0.56,0
1509,25,0,1534,0.45,0
1538,10,24,1572,0.55,0
1511,-20,0,1491,0.4,0
1537,-2,24,1559,0.6,1
1512,20,-2,1530,0.43,0
1536,19,26,1581,0.57,0
1510,-13,0,1497,0.49,1
1465,17,24,1506,0.51,1
1512,-14,0,1498,0.54,0
1463,-16,24,1471,0.46,1
1515,27,-3,1539,0.58,0
1460,-2,21,1479,0.42,1
1520,0,0,1520,0.47,1
1518,0,24,1542,0.53,1
1518,24,0,1542,0.47,1
1520,22,24,1566,0.53,0
1517,18,0,1535,0.51,0
1521,-16,26,1531,0.49,0
1455,-13,0,1442,0.37,0
1522,-13,24,1533,0.63,0
1456,14,-1,1469,0.35,0
1522,28,26,1576,0.65,1
1468,20,0,1488,0.43,1
1525,-11,24,1538,0.57,0
1470,-1,0,1469,0.36,0
1523,19,24,1566,0.64,1
1468,0,-4,1464,0.41,1
1525,-17,20,1528,0.59,0
1526,-8,0,1518,0.43,1
1554,-13,24,1565,0.57,1
1527,21,0,1548,0.45,0
1553,5,24,1582,0.55,1
1525,-6,0,1519,0.43,1
1554,-13,24,1565,0.57,1
1526,15,-2,1539,0.41,0
1554,24,21,1599,0.59,0
1527,-16,0,1511,0.58,0
1434,-2,24,1456,0.42,1
1526,-6,0,1520,0.58,1
1435,6,24,1465,0.42,1
1525,15,-2,1538,0.6,0
1436,10,23,1469,0.4,0
1446,10,0,1456,0.4,0
1526,-22,24,1528,0.6,0
1447,-8,0,1439,0.33,0
1526,13,24,1563,0.67,1
1448,14,-4,1458,0.38,0
1524,-6,24,1542,0.62,1
1587,0,0,1587,0.54,0
1523,12,24,1559,0.46,0
1588,15,0,1603,0.62,0
1521,-23,24,1522,0.38,0
1591,-5,-4,1582,0.58,0
1519,-16,24,1527,0.42,1
1450,-9,0,1441,0.33,1
1521,16,24,1561,0.67,0
1451,1,0,1452,0.38,0
1520,-8,24,1536,0.62,0
1449,-1,-1,1447,0.35,1
1522,15,22,1559,0.65,0
1520,-19,0,1501,0.53,1
1491,-37,24,1478,0.47,0
1521,19,0,1540,0.51,1
1489,19,24,1532,0.49,1
1518,-27,0,1491,0.5,1
1493,-29,24,1488,0.5,1
1519,-9,-3,1507,0.45,0
1491,31,20,1542,0.55,0
1520,15,0,1535,0.48,1
1515,14,24,1553,0.52,1
1519,-21,0,1498,0.45,1
1517,-9,24,1532,0.55,1
1517,18,-2,1533,0.5,1
1518,-9,23,1532,0.5,1
1516,-15,0,1501,0.48,1
1483,10,24,1517,0.52,1
1517,-8,0,1509,0.54,0
1482,-22,24,1484,0.46,0
1519,20,-2,1537,0.55,0
1479,-3,24,1500,0.45,1
1538,-36,0,1502,0.48,0
1517,-22,24,1519,0.52,1
1539,7,0,1546,0.48,1
1516,19,24,1559,0.52,1
1535,-28,-3,1504,0.46,1
1520,-13,24,1531,0.54,0
1541,-13,0,1528,0.48,1
1523,-4,24,1543,0.52,0
1540,11,0,1551,0.48,0
1524,20,24,1568,0.52,0
1539,2,-4,1537,0.52,1
1525,-24,23,1524,0.48,1
1527,15,0,1542,0.58,0
1458,3,24,1485,0.42,1
1525,-11,0,1514,0.54,1
1460,0,24,1484,0.46,1
1524,-6,-3,1515,0.54,1
1461,0,24,1485,0.46,1
1528,28,0,1556,0.5,1
1505,24,24,1553,0.5,1
1529,-27,0,1502,0.47,0
1503,0,24,1527,0.53,1
1527,11,-2,1536,0.54,1
1506,-18,24,1512,0.46,0
1463,2,0,1465,0.4,0
1525,-14,24,1535,0.6,1
1465,2,0,1467,0.4,0
1523,-7,24,1540,0.6,1
1467,0,-3,1464,0.35,1
1522,28,24,1574,0.65,1
1508,3,0,1511,0.49,0
1521,-27,24,1518,0.51,1
1510,-3,0,1507,0.43,1
1519,14,24,1557,0.57,1
1509,-25,0,1484,0.44,0
1520,-16,24,1528,0.56,0
1506,13,-4,1515,0.5,1
1523,-30,22,1515,0.5,0
1525,-7,0,1518,0.38,0
1589,-10,24,1603,0.62,1
1526,28,0,1554,0.41,0
1588,5,26,1619,0.59,0
1459,2,0,1461,0.38,1
1529,-10,24,1543,0.62,1
1460,-9,0,1451,0.34,0
1528,16,24,1568,0.66,1
1455,-4,-4,1447,0.35,1
1533,-5,26,1554,0.65,1
1461,-16,0,1445,0.38,0
1534,-26,24,1532,0.62,0
1463,-7,1,1457,0.34,0
1533,23,20,1576,0.66,1
1531,-26,-3,1502,0.37,1
1540,33,21,1594,0.63,0
1528,16,0,1544,0.59,1
1461,-5,24,1480,0.41,0
1527,-6,0,1521,0.55,1
1463,-3,24,1484,0.45,0
1524,-29,-2,1493,0.52,1
1465,-11,24,1478,0.48,0
1526,-5,0,1521,0.49,0
1529,-21,24,1532,0.51,1
1525,20,0,1545,0.47,1
1531,9,24,1564,0.53,0
1526,20,0,1546,0.45,0
1530,26,24,1580,0.55,0
1527,-12,0,1515,0.48,1
1529,-27,26,1528,0.52,1
1524,-10,0,1514,0.5,1
1498,-11,24,1511,0.5,0
1523,-6,0,1517,0.49,1
1499,2,24,1525,0.51,0
1521,16,-2,1535,0.52,1
1501,-5,24,1520,0.48,0
1532,9,0,1541,0.47,0
1520,17,24,1561,0.53,0
1536,0,0,1536,0.51,0
1517,-11,24,1530,0.49,1
1534,-49,-3,1482,0.42,1
1518,-7,24,1535,0.58,0
1489,12,0,1501,0.44,0
1517,-1,24,1540,0.56,0
1488,8,0,1496,0.41,0
1519,15,24,1558,0.59,0
1488,20,-4,1504,0.42,1
1518,17,24,1559,0.58,1
1458,9,0,1467,0.43,0
1495,-6,24,1513,0.57,1
1459,-26,0,1433,0.38,1
1494,-3,24,1515,0.62,1
1460,-35,-3,1422,0.35,0
1493,10,24,1527,0.65,1
1518,4,0,1522,0.52,0
1494,-12,24,1506,0.48,0
1516,25,0,1541,0.57,1
1496,-31,24,1489,0.43,0
1517,-14,0,1503,0.44,0
1494,27,24,1545,0.56,1
1519,17,-2,1534,0.53,1
1492,-3,21,1510,0.47,1
1494,0,0,1494,0.52,0
1447,6,24,1477,0.48,1
1491,9,0,1500,0.54,1
1450,-1,24,1473,0.46,0
1492,-15,-1,1476,0.49,0
1449,13,21,1483,0.51,1
1495,31,0,1526,0.54,0
1460,11,24,1495,0.46,1
1498,3,0,1501,0.57,1
1457,-32,24,1449,0.43,1
1499,-29,0,1470,0.53,0
1456,-15,24,1465,0.47,1
1501,-1,-1,1499,0.55,0
1454,-11,24,1467,0.45,1
1591,-8,0,1583,0.58,0
1499,2,24,1525,0.42,0
1590,-2,0,1588,0.61,1
1501,-16,24,1509,0.39,0
1588,16,-1,1603,0.65,1
1503,-35,26,1494,0.35,1
1522,-3,0,1519,0.45,0
1502,30,24,1556,0.55,1
1523,-13,0,1510,0.48,1
1501,3,24,1528,0.52,1
1521,-6,0,1515,0.52,1
1503,-24,24,1503,0.48,0
1522,-1,0,1521,0.5,0
1502,-5,24,1521,0.5,0
1519,23,-3,1539,0.51,1
1505,5,24,1534,0.49,0
1544,-14,0,1530,0.52,1
1507,-15,24,1516,0.48,0
1542,-30,0,1512,0.43,1
1509,30,24,1563,0.57,0
1541,11,-1,1551,0.53,1
1511,2,21,1534,0.47,0
1511,-9,0,1502,0.45,0
1516,-5,24,1535,0.55,0
1510,11,0,1521,0.43,1
1518,29,24,1571,0.57,1
1509,-18,-2,1489,0.4,1
1519,18,23,1560,0.6,1
1507,30,0,1537,0.41,1
1587,-14,24,1597,0.59,0
1509,5,0,1514,0.37,0
1586,0,24,1610,0.63,1
1507,-12,-3,1492,0.32,0
1587,11,26,1624,0.68,0
1506,8,0,1514,0.56,1
1452,-5,24,1471,0.44,0
1505,-26,0,1479,0.51,1
1454,-7,24,1471,0.49,1
1504,31,-1,1534,0.58,1
1454,3,23,1480,0.42,0
1438,-4,0,1434,0.36,0
1503,5,24,1532,0.64,1
1436,38,0,1474,0.43,1
1506,-10,24,1520,0.57,1
1436,-1,0,1435,0.36,0
1505,9,24,1538,0.64,0
1438,-7,-3,1428,0.39,1
1504,-24,24,1504,0.61,1
1480,11,0,1491,0.41,0
1502,29,24,1555,0.59,1
1479,-18,0,1461,0.44,1
1504,-27,24,1501,0.56,0
1480,8,-1,1487,0.44,0
1503,5,24,1532,0.56,1
1502,-15,0,1487,0.56,0
1441,-17,24,1448,0.44,0
1503,10,0,1513,0.54,1
1439,22,24,1485,0.46,1
1502,25,0,1527,0.6,1
1441,-6,24,1459,0.4,0
1451,8,0,1459,0.45,0
1500,-30,24,1494,0.55,1
1453,2,0,1455,0.4,0
1498,6,24,1528,0.6,1
1455,-7,-3,1445,0.42,0
1497,-16,23,1504,0.58,1
1498,11,0,1509,0.57,0
1458,-19,24,1463,0.43,0
1496,25,2,1523,0.57,1
1460,-11,26,1475,0.43,0
1497,-23,-3,1471,0.47,0
1459,15,21,1495,0.53,1
1497,7,0,1504,0.4,0
1553,-2,24,1575,0.6,0
1499,-12,0,1487,0.38,0
1552,-4,24,1572,0.62,1
1496,7,-3,1500,0.4,1
1555,-5,24,1574,0.6,0
1457,-10,2,1449,0.36,1
1498,24,26,1548,0.64,0
1459,12,-1,1470,0.46,0
1496,-21,24,1499,0.54,1
1478,16,2,1496,0.45,1
1497,5,26,1528,0.55,0
1477,6,0,1483,0.46,1
1499,-10,23,1512,0.54,1
1500,8,0,1508,0.43,0
1517,17,24,1558,0.57,0
1499,26,0,1525,0.49,0
1518,-7,24,1535,0.51,0
1500,-17,3,1486,0.4,1
1516,17,24,1557,0.6,1
1501,6,0,1507,0.4,0
1532,22,24,1578,0.6,1
1499,-11,-2,1486,0.39,1
1534,6,21,1561,0.61,1
1549,25,0,1574,0.61,0
1498,-26,24,1496,0.39,1
1552,-15,0,1537,0.52,0
1495,5,24,1524,0.48,1
1550,21,2,1573,0.52,1
1497,32,26,1555,0.48,0
1551,11,-2,1560,0.59,1
1496,-20,24,1500,0.41,1
1541,-15,0,1526,0.5,1
1495,4,24,1523,0.5,1
1540,26,3,1569,0.58,1
1496,-9,25,1512,0.42,1
1494,-1,0,1493,0.51,1
1460,0,24,1484,0.49,0
1493,33,0,1526,0.57,0
1462,-8,24,1478,0.43,0
1491,-15,-2,1474,0.42,1
1463,38,25,1526,0.58,1
1493,4,0,1497,0.46,0
1524,-24,24,1524,0.54,1
1494,-3,0,1491,0.39,1
1522,25,24,1571,0.61,1
1496,-2,0,1494,0.42,0
1521,2,24,1547,0.58,1
1497,33,-4,1526,0.48,0
1519,-2,24,1541,0.52,0
1499,-13,0,1486,0.36,0
1553,11,24,1588,0.64,1
1500,2,0,1502,0.39,1
1553,0,24,1577,0.61,1
1501,-18,-2,1481,0.37,0
1552,-2,22,1572,0.63,1
1539,16,0,1555,0.55,0
1499,-7,24,1516,0.45,1
1540,-18,0,1522,0.51,0
1498,-5,24,1517,0.49,0
1543,-31,3,1515,0.44,0
1495,30,29,1554,0.56,1
1524,-10,0,1514,0.5,1
1498,-11,24,1511,0.5,0
1523,-6,0,1517,0.49,1
1499,2,24,1525,0.51,0
1521,16,-2,1535,0.52,1
1501,-5,24,1520,0.48,0
1499,-7,0,1492,0.47,1
1499,-12,24,1511,0.53,0
1496,30,-3,1523,0.47,1
1502,19,24,1545,0.53,1
1495,-8,0,1487,0.48,1
1470,7,24,1501,0.52,1
1491,2,0,1493,0.49,1
1474,-1,24,1497,0.51,0
1491,-8,2,1485,0.48,0
1473,0,26,1499,0.52,0
1493,30,-3,1520,0.52,0
1472,8,24,1504,0.48,0
1517,-4,0,1513,0.54,1
1477,-14,24,1487,0.46,0
1516,8,0,1524,0.57,0
1477,-28,24,1473,0.43,0
1514,30,0,1544,0.56,1
1479,0,24,1503,0.44,0
1513,0,-3,1510,0.49,1
1480,14,24,1518,0.51,1
1512,-32,0,1480,0.52,0
1441,-1,24,1464,0.48,0
1511,-5,1,1507,0.54,1
1442,14,26,1482,0.46,1
1536,-23,0,1513,0.45,1
1510,10,24,1544,0.55,1
1537,29,0,1566,0.51,0
1509,29,24,1562,0.49,0
1539,-1,0,1538,0.52,0
1507,-10,24,1521,0.48,1
1541,-25,-3,1513,0.48,0
1505,-1,23,1527,0.52,1
1502,13,0,1515,0.4,1
1538,24,24,1586,0.6,0
1499,-9,-3,1487,0.39,1
1542,-1,23,1564,0.61,0
1429,37,0,1466,0.38,0
1498,28,24,1550,0.62,0
1429,0,0,1429,0.39,0
1498,-18,24,1504,0.61,0
1427,-8,0,1419,0.35,0
1499,2,24,1525,0.65,0
1428,-3,-4,1421,0.33,1
1499,19,24,1542,0.67,1
1457,-2,0,1455,0.42,0
1497,-7,24,1514,0.58,1
1458,-7,0,1451,0.37,0
1496,24,24,1544,0.63,0
1455,26,-4,1477,0.44,1
1499,-2,21,1518,0.56,0
1500,1,0,1501,0.48,0
1507,-20,24,1511,0.52,0
1498,21,0,1519,0.47,1
1509,6,24,1539,0.53,0
1497,-8,-2,1487,0.43,1
1510,2,26,1538,0.57,0
1496,20,0,1516,0.55,0
1429,31,24,1484,0.45,0
1493,-9,0,1484,0.53,1
1432,8,24,1464,0.47,0
1491,1,-1,1491,0.56,1
1434,-12,26,1448,0.44,0
1510,-20,0,1490,0.43,1
1494,21,24,1539,0.57,0
1508,-30,0,1478,0.47,0
1495,-17,24,1502,0.53,0
1507,6,0,1513,0.5,1
1497,-7,24,1514,0.5,0
1510,10,0,1520,0.48,0
1494,18,24,1536,0.52,1
1508,22,-3,1527,0.52,1
1496,-9,24,1511,0.48,0
1519,27,0,1546,0.54,1
1498,0,24,1522,0.46,0
1521,24,0,1545,0.51,0
1496,21,24,1541,0.49,1
1520,-4,-3,1513,0.49,0
1497,-3,24,1518,0.51,0
1535,-39,0,1496,0.44,0
1498,15,24,1537,0.56,0
1537,0,0,1537,0.52,1
1497,-1,24,1520,0.48,1
1536,-11,-3,1522,0.5,1
1498,2,22,1522,0.5,0
1496,22,0,1518,0.44,1
1552,-18,24,1558,0.56,0
1497,-5,0,1492,0.33,0
1551,38,24,1613,0.67,1
1495,20,-2,1513,0.41,1
1553,1,21,1575,0.59,1
1494,-4,0,1490,0.45,1
1481,19,24,1524,0.55,1
1495,0,0,1495,0.5,0
1480,-10,24,1494,0.5,0
1494,20,-3,1511,0.5,1
1481,7,24,1512,0.5,0
1493,-5,0,1488,0.52,1
1442,7,24,1473,0.48,1
1496,24,0,1520,0.6,0
1438,-13,24,1449,0.4,1
1493,-12,-2,1479,0.52,1
1441,0,22,1463,0.48,0
1548,-5,0,1543,0.54,0
1494,-1,24,1517,0.46,0
1551,-11,0,1540,0.51,0
1492,17,24,1533,0.49,1
1554,46,-2,1598,0.62,0
1489,-5,26,1510,0.38,1
1452,-2,0,1450,0.37,1
1491,29,24,1544,0.63,0
1451,0,0,1451,0.42,1
1492,-8,24,1508,0.58,1
1451,-4,-3,1444,0.4,1
1492,3,20,1515,0.6,1
1493,17,0,1510,0.44,1
1526,0,24,1550,0.56,1
1494,-1,0,1493,0.44,1
1525,-17,24,1532,0.56,1
1496,28,0,1524,0.48,0
1523,-6,24,1541,0.52,1
1498,-4,-2,1492,0.43,1
1521,-2,24,1543,0.57,1
1495,0,0,1495,0.36,1
1547,21,24,1592,0.64,0
1496,13,0,1509,0.41,0
1546,2,24,1572,0.59,0
1498,0,-2,1496,0.43,0
1544,-24,21,1541,0.57,1
1497,30,0,1527,0.48,1
1534,-15,24,1543,0.52,1
1498,-3,0,1495,0.4,1
1533,11,24,1568,0.6,1
1496,-2,-2,1492,0.37,0
1535,29,22,1586,0.63,0
1517,-40,0,1477,0.41,1
1498,15,24,1537,0.59,0
1518,10,0,1528,0.47,1
1497,30,24,1551,0.53,1
1514,-7,-4,1503,0.46,1
1501,5,24,1530,0.54,0
1534,-20,0,1514,0.5,0
1499,-11,24,1512,0.5,0
1532,17,0,1549,0.53,1
1502,1,24,1527,0.47,0
1531,0,0,1531,0.48,1
1503,17,24,1544,0.52,1
1530,18,-3,1545,0.49,1
1504,30,20,1554,0.51,0
1505,-25,0,1480,0.32,0
1543,45,24,1612,0.68,1
1507,3,0,1510,0.42,0
1541,4,24,1569,0.58,1
1508,3,-3,1508,0.45,0
1540,-18,21,1543,0.55,0
1506,16,0,1522,0.47,1
1497,19,24,1540,0.53,0
1508,31,0,1539,0.56,0
1495,-25,24,1494,0.44,0
1509,-14,-2,1493,0.51,1
1494,-26,21,1489,0.49,1
1510,0,0,1510,0.45,0
1528,-10,24,1542,0.55,0
1511,3,0,1514,0.44,0
1527,8,24,1559,0.56,0
1509,11,-2,1518,0.44,1
1530,0,26,1556,0.56,1
1464,2,0,1466,0.36,1
1508,31,24,1563,0.64,1
1466,-5,0,1461,0.42,1
1506,-9,24,1521,0.58,1
1467,9,-4,1472,0.42,0
1505,-2,24,1527,0.58,1
1460,-2,0,1458,0.39,1
1507,8,24,1539,0.61,1
1462,13,0,1475,0.41,0
1505,8,24,1537,0.59,1
1463,19,-2,1480,0.39,0
1504,30,26,1560,0.61,1
1545,0,0,1545,0.54,0
1502,-9,24,1517,0.46,1
1544,39,0,1583,0.58,1
1503,-2,24,1525,0.42,0
1547,-13,-1,1533,0.51,0
1500,5,20,1525,0.49,1
1497,7,0,1504,0.43,1
1546,-19,24,1551,0.57,0
1499,38,0,1537,0.5,1
1545,-31,24,1538,0.5,1
1500,-12,-2,1486,0.43,0
1544,-34,24,1534,0.57,0
1501,0,0,1501,0.45,0
1514,-5,24,1533,0.55,1
1503,13,0,1516,0.45,1
1512,13,24,1549,0.55,1
1502,2,0,1504,0.42,1
1513,23,24,1560,0.58,0
1501,37,-3,1535,0.49,0
1514,5,24,1543,0.51,0
1488,-20,-3,1465,0.49,1
1439,5,28,1472,0.51,0
1475,24,4,1503,0.46,1
1491,11,31,1533,0.54,0
1535,22,0,1557,0.58,1
1493,-16,24,1501,0.42,0
1532,-12,0,1520,0.54,1
1496,-29,24,1491,0.46,0
1531,-17,-1,1513,0.42,0
1497,46,24,1567,0.58,0
1441,4,0,1445,0.43,0
1497,-27,24,1494,0.57,0
1442,5,0,1447,0.38,1
1496,12,24,1532,0.62,1
1441,-8,0,1433,0.42,0
1497,-34,24,1487,0.58,0
1438,-4,-3,1431,0.39,1
1500,-14,21,1507,0.61,0
1498,46,0,1544,0.47,0
1545,-1,24,1568,0.53,0
1499,-27,0,1472,0.39,1
1544,-19,24,1549,0.61,1
1497,11,0,1508,0.4,1
1546,6,24,1576,0.6,0
1499,-29,-3,1467,0.41,0
1544,-35,21,1530,0.59,1
1502,36,0,1538,0.54,1
1501,-15,24,1510,0.46,0
1503,4,-1,1506,0.42,0
1500,40,21,1561,0.58,0
1499,-34,0,1465,0.51,0
1448,-13,24,1459,0.49,0
1497,11,0,1508,0.54,1
1450,6,24,1480,0.46,1
1496,-27,0,1469,0.49,1
1451,3,24,1478,0.51,0
1494,-14,-1,1479,0.48,1
1453,12,26,1491,0.52,0
1493,42,0,1535,0.5,1
1518,-10,24,1532,0.5,0
1494,-33,0,1461,0.39,0
1517,0,24,1541,0.61,1
1497,15,-3,1509,0.43,0
1514,22,24,1560,0.57,1
1547,-20,0,1527,0.56,0
1496,-31,24,1489,0.44,0
1546,8,0,1554,0.57,1
1497,-13,24,1508,0.43,0
1545,-5,-1,1539,0.46,1
1498,44,24,1566,0.54,0
1456,12,0,1468,0.47,0
1497,-34,24,1487,0.53,0
1457,-3,0,1454,0.39,1
1496,12,24,1532,0.61,1
1458,-9,-2,1447,0.44,1
1495,-25,21,1491,0.56,1
1497,-15,0,1482,0.41,0
1546,-25,24,1545,0.59,1
1495,41,0,1536,0.44,1
1548,5,24,1577,0.56,0
1496,-31,0,1465,0.37,0
1548,-11,24,1561,0.63,0
1498,16,1,1515,0.43,1
1545,-8,24,1561,0.57,1
1499,-34,0,1465,0.4,0
1526,-14,24,1536,0.6,0
1497,-11,0,1486,0.42,1
1528,-13,24,1539,0.58,1
1498,39,-3,1534,0.45,0
1527,16,24,1567,0.55,0
1499,-20,0,1479,0.32,1
1545,42,24,1611,0.68,1
1496,-40,0,1456,0.33,1
1548,4,24,1576,0.67,0
1494,17,-3,1508,0.41,1
1550,-1,26,1575,0.59,1
1457,45,0,1502,0.5,1
1492,-13,24,1503,0.5,1
1458,7,0,1465,0.38,0
1492,34,24,1550,0.62,0
1461,-6,-1,1454,0.45,0
1489,-25,26,1490,0.55,1
1520,-19,0,1501,0.53,1
1491,-37,24,1478,0.47,0
1521,19,0,1540,0.51,1
1489,19,24,1532,0.49,1
1518,-27,0,1491,0.5,1
1493,-29,24,1488,0.5,1
1519,-9,-3,1507,0.45,0
1491,31,20,1542,0.55,0
1492,-6,0,1486,0.51,1
1453,4,24,1481,0.49,1
1488,-37,2,1453,0.45,1
1457,4,26,1487,0.55,0
1491,17,-3,1505,0.57,0
1454,-20,20,1454,0.43,1
1491,-29,0,1462,0.33,0
1538,25,24,1587,0.67,1
1490,26,0,1516,0.48,1
1540,-32,24,1532,0.52,0
1491,-3,0,1488,0.39,1
1539,1,24,1564,0.61,1
1491,-20,0,1471,0.36,1
1531,18,24,1573,0.64,1
1493,19,0,1512,0.41,0
1530,23,23,1576,0.59,1
1542,1,0,1543,0.51,0
1492,22,24,1538,0.49,1
1541,-22,0,1519,0.55,1
1493,-31,24,1486,0.45,0
1539,11,-1,1549,0.54,1
1494,2,26,1522,0.46,0
1460,2,0,1462,0.39,1
1495,22,24,1541,0.61,1
1462,-10,0,1452,0.45,0
1494,-29,24,1489,0.55,1
1463,-7,-3,1453,0.39,0
1492,18,24,1534,0.61,1
1542,4,0,1546,0.58,1
1493,-28,24,1489,0.42,0
1545,-3,0,1542,0.54,0
1491,1,24,1516,0.46,1
1544,38,-1,1581,0.57,0
1492,20,22,1534,0.43,0
1489,16,0,1505,0.49,1
1469,18,24,1511,0.51,0
1491,-18,0,1473,0.48,0
1467,-4,24,1487,0.52,1
1492,-27,-2,1463,0.49,0
1466,-19,24,1471,0.51,1
1493,1,0,1494,0.39,0
1538,10,24,1572,0.61,0
1489,17,0,1506,0.41,1
1541,1,24,1566,0.59,0
1490,18,0,1508,0.42,0
1540,-3,24,1561,0.58,0
1491,-18,-4,1469,0.44,0
1539,-47,20,1512,0.56,0
1463,1,0,1464,0.46,1
1492,-23,24,1493,0.54,1
1462,-23,0,1439,0.38,1
1494,5,24,1523,0.62,1
1460,23,-3,1480,0.42,1
1495,18,24,1537,0.58,1
1506,16,0,1522,0.47,1
1497,19,24,1540,0.53,0
1508,31,0,1539,0.56,0
1495,-25,24,1494,0.44,0
1509,-14,-2,1493,0.51,1
1494,-26,21,1489,0.49,1
1493,1,0,1494,0.54,0
1456,-16,24,1464,0.46,0
1492,16,0,1508,0.56,0
1457,-14,24,1467,0.44,0
1491,21,-1,1511,0.53,1
1459,4,26,1489,0.47,0
1489,-26,0,1463,0.39,1
1545,-30,24,1539,0.61,1
1487,-21,0,1466,0.35,1
1547,1,24,1572,0.65,1
1489,1,-3,1487,0.43,0
1546,-34,22,1534,0.57,0
1508,-18,0,1490,0.45,0
1487,11,24,1522,0.55,1
1507,7,0,1514,0.48,0
1488,18,24,1530,0.52,0
1505,27,-1,1531,0.55,1
1490,-22,26,1494,0.45,0
1519,32,0,1551,0.59,0
1486,-21,24,1489,0.41,1
1517,2,0,1519,0.49,1
1489,10,24,1523,0.51,0
1519,-17,0,1502,0.47,0
1487,9,24,1520,0.53,1
1520,-6,-3,1511,0.48,0
1486,17,22,1525,0.52,1
1486,-28,0,1458,0.38,0
1515,1,24,1540,0.62,1
1488,-19,-2,1467,0.4,0
1514,-1,24,1537,0.6,1
1489,12,0,1501,0.44,0
1517,-1,24,1540,0.56,0
1488,8,0,1496,0.41,0
1519,15,24,1558,0.59,0
1488,20,-4,1504,0.42,1
1518,17,24,1559,0.58,1
1550,-20,0,1530,0.58,0
1459,-7,24,1476,0.42,0
1550,42,0,1592,0.66,1
1459,-4,24,1479,0.34,0
1549,1,2,1552,0.57,0
1460,18,26,1504,0.43,0
1546,-21,-3,1522,0.55,1
1463,1,24,1488,0.45,0
1544,4,0,1548,0.43,1
1561,11,24,1596,0.57,0
1545,-21,0,1524,0.41,0
1560,6,24,1590,0.59,1
1543,41,-3,1581,0.45,1
1561,29,24,1614,0.55,0
1498,46,0,1544,0.47,0
1545,-1,24,1568,0.53,0
1499,-27,0,1472,0.39,1
1544,-19,24,1549,0.61,1
1497,11,0,1508,0.4,1
1546,6,24,1576,0.6,0
1499,-29,-3,1467,0.41,0
1544,-35,21,1530,0.59,1
1542,-16,0,1526,0.56,1
1466,-8,24,1482,0.44,0
1543,40,0,1583,0.65,0
1464,-12,24,1476,0.35,0
1542,0,-3,1539,0.58,1
1466,-4,24,1486,0.42,1
1485,21,0,1506,0.44,0
1540,-18,24,1546,0.56,1
1482,17,0,1499,0.45,1
1543,-29,24,1538,0.55,0
1483,-14,-1,1468,0.38,0
1542,-16,26,1552,0.62,1
1556,29,0,1585,0.53,0
1543,-5,24,1562,0.47,0
1553,1,1,1555,0.5,1
1546,-15,23,1554,0.5,0
1547,-20,0,1527,0.56,0
1496,-31,24,1489,0.44,0
1546,8,0,1554,0.57,1
1497,-13,24,1508,0.43,0
1545,-5,-1,1539,0.46,1
1498,44,24,1566,0.54,0
1546,-10,0,1536,0.45,0
1550,-3,24,1571,0.55,1
1548,-29,-3,1516,0.44,0
1548,-20,26,1554,0.56,1
1497,-15,0,1482,0.41,0
1546,-25,24,1545,0.59,1
1495,41,0,1536,0.44,1
1548,5,24,1577,0.56,0
1496,-31,0,1465,0.37,0
1548,-11,24,1561,0.63,0
1498,16,1,1515,0.43,1
1545,-8,24,1561,0.57,1
1530,-33,0,1497,0.43,1
1545,-22,24,1547,0.57,1
1528,36,0,1564,0.52,1
1547,-22,24,1549,0.48,0
1529,-18,0,1511,0.42,0
1546,-1,22,1567,0.58,1
1544,-15,0,1529,0.48,1
1512,5,24,1541,0.52,0
1546,-4,0,1542,0.5,1
1510,8,24,1542,0.5,1
1544,-21,1,1524,0.5,1
1512,-15,24,1521,0.5,0
1548,4,0,1552,0.48,0
1543,-2,24,1565,0.52,1
1550,-17,0,1533,0.46,0
1541,-2,24,1563,0.54,1
1548,-9,-1,1538,0.46,1
1543,0,20,1563,0.54,1
1546,-32,0,1514,0.36,1
1592,0,24,1616,0.64,1
1543,-23,0,1520,0.36,1
1595,2,24,1621,0.64,1
1545,5,0,1550,0.43,0
1593,-18,24,1599,0.57,1
1546,-18,-4,1524,0.37,0
1592,3,24,1619,0.63,0
1459,2,0,1461,0.37,0
1544,-11,24,1557,0.63,1
1462,-7,0,1455,0.39,0
1542,-36,24,1530,0.61,1
1464,4,-2,1466,0.39,1
1540,-21,24,1543,0.61,1
1519,30,0,1549,0.48,1
1539,2,24,1565,0.52,1
1521,-12,0,1509,0.45,0
1536,-17,24,1543,0.55,1
1522,-38,-3,1481,0.41,1
1535,-11,22,1546,0.59,1
1538,-36,0,1502,0.48,0
1517,-22,24,1519,0.52,1
1539,7,0,1546,0.48,1
1516,19,24,1559,0.52,1
1535,-28,-3,1504,0.46,1
1520,-13,24,1531,0.54,0
1534,-27,0,1507,0.53,0
1462,1,24,1487,0.47,0
1537,-41,0,1496,0.59,0
1458,-47,24,1435,0.41,1
1536,-17,-2,1517,0.53,1
1460,6,29,1495,0.47,0
1506,1,0,1507,0.41,1
1535,12,24,1571,0.59,1
1508,-16,0,1492,0.37,1
1533,31,24,1588,0.63,1
1507,-12,0,1495,0.45,1
1534,-27,24,1531,0.55,0
1508,17,-1,1524,0.52,0
1533,-45,26,1514,0.48,0
1497,30,0,1527,0.48,1
1534,-15,24,1543,0.52,1
1498,-3,0,1495,0.4,1
1533,11,24,1568,0.6,1
1496,-2,-2,1492,0.37,0
1535,29,22,1586,0.63,0
1533,-32,0,1501,0.53,1
1465,-10,24,1479,0.47,0
1536,-19,0,1517,0.56,0
1462,-9,24,1477,0.44,1
1534,-18,0,1516,0.56,1
1464,-12,22,1474,0.44,0
1532,10,0,1542,0.56,1
1516,-40,24,1500,0.44,0
1534,30,5,1569,0.55,0
1515,-7,29,1537,0.45,0
1532,-28,-1,1503,0.44,1
1516,7,24,1547,0.56,1
1540,3,0,1543,0.51,1
1535,-22,24,1537,0.49,0
1542,-20,0,1522,0.48,0
1533,-24,24,1533,0.52,0
1543,8,0,1551,0.54,1
1532,-31,24,1525,0.46,1
1542,26,-3,1565,0.5,1
1534,8,24,1566,0.5,0
1520,-15,0,1505,0.38,1
1533,33,24,1590,0.62,1
1519,-7,0,1512,0.48,1
1534,-31,24,1527,0.52,0
1520,6,-1,1525,0.49,0
1533,-26,23,1530,0.51,0
1535,-18,0,1517,0.49,1
1505,-4,24,1525,0.51,1
1533,5,0,1538,0.54,0
1507,-19,24,1512,0.46,0
1532,29,-3,1558,0.53,1
1508,9,22,1539,0.47,0
1530,-28,0,1502,0.53,1
1458,1,24,1483,0.47,0
1532,-45,0,1487,0.54,0
1456,-17,24,1463,0.46,1
1531,-34,-4,1493,0.5,1
1457,19,20,1496,0.5,1
1526,-5,0,1521,0.49,0
1529,-21,24,1532,0.51,1
1525,20,0,1545,0.47,1
1531,9,24,1564,0.53,0
1526,20,0,1546,0.45,0
1530,26,24,1580,0.55,0
1527,-12,0,1515,0.48,1
1529,-27,26,1528,0.52,1
1457,-18,0,1439,0.39,0
1527,-36,24,1515,0.61,1
1455,21,0,1476,0.43,0
1528,-24,24,1528,0.57,0
1457,-28,-2,1427,0.32,0
1527,9,25,1561,0.68,1
1525,27,0,1552,0.51,1
1522,-1,24,1545,0.49,1
1523,-30,0,1493,0.38,0
1523,30,24,1577,0.62,0
1524,-31,-2,1491,0.41,1
1523,5,24,1552,0.59,1
1526,-26,0,1500,0.54,0
1464,-15,24,1473,0.46,1
1524,7,0,1531,0.56,1
1466,-4,24,1486,0.44,0
1522,30,0,1552,0.6,1
1467,-7,24,1484,0.4,0
1520,-33,-2,1485,0.5,1
1469,-11,24,1482,0.5,0
1562,7,0,1569,0.65,0
1437,1,24,1462,0.35,1
1561,27,0,1588,0.66,1
1438,7,24,1469,0.34,0
1559,-18,0,1541,0.62,1
1439,-8,24,1455,0.38,1
1559,-16,-3,1540,0.59,1
1440,13,24,1477,0.41,1
1512,-32,0,1480,0.52,0
1441,-1,24,1464,0.48,0
1511,-5,1,1507,0.54,1
1442,14,26,1482,0.46,1
1443,5,0,1448,0.34,0
1561,-20,24,1565,0.66,1
1443,-8,0,1435,0.32,0
1560,-16,24,1568,0.68,1
1445,7,-3,1449,0.31,0
1559,10,24,1593,0.69,1
1446,-17,0,1429,0.38,0
1534,-43,24,1515,0.62,1
1445,9,0,1454,0.32,0
1536,25,24,1585,0.68,0
1447,6,-2,1451,0.4,0
1533,-40,26,1519,0.6,1
1499,-34,0,1465,0.51,0
1448,-13,24,1459,0.49,0
1497,11,0,1508,0.54,1
1450,6,24,1480,0.46,1
1496,-27,0,1469,0.49,1
1451,3,24,1478,0.51,0
1494,-14,-1,1479,0.48,1
1453,12,26,1491,0.52,0
1435,1,0,1436,0.43,1
1454,8,24,1486,0.57,1
1436,7,0,1443,0.48,0
1453,-20,24,1457,0.52,0
1437,-8,-3,1426,0.43,0
1452,5,21,1478,0.57,0
1451,-4,0,1447,0.43,1
1482,-8,24,1498,0.57,1
1452,10,0,1462,0.47,0
1481,-23,24,1482,0.53,0
1450,10,-1,1459,0.42,0
1482,8,26,1516,0.58,0
1452,-17,0,1435,0.41,0
1446,26,24,1496,0.59,1
1451,2,1,1454,0.47,0
1448,2,26,1476,0.53,0
1533,-16,0,1517,0.57,0
1448,-6,24,1466,0.43,1
1532,18,0,1550,0.6,0
1449,7,24,1480,0.4,0
1531,-46,0,1485,0.5,1
1450,13,24,1487,0.5,1
1530,-13,0,1517,0.58,1
1451,-13,24,1462,0.42,0
1527,30,-2,1555,0.62,1
1453,-8,24,1469,0.38,0
1553,-17,0,1536,0.58,1
1455,2,24,1481,0.42,0
1551,28,0,1579,0.63,1
1457,5,24,1486,0.37,1
1550,-5,-3,1542,0.57,1
1458,10,24,1492,0.43,1
1528,-30,0,1498,0.51,1
1460,8,24,1492,0.49,0
1529,-2,0,1527,0.58,1
1458,-9,24,1473,0.42,1
1532,-26,-3,1503,0.54,1
1455,-1,21,1475,0.46,1
1457,45,0,1502,0.5,1
1492,-13,24,1503,0.5,1
1458,7,0,1465,0.38,0
1492,34,24,1550,0.62,0
1461,-6,-1,1454,0.45,0
1489,-25,26,1490,0.55,1
1459,-12,0,1447,0.37,1
1479,33,24,1536,0.63,1
1458,-2,0,1456,0.41,1
1481,13,24,1518,0.59,1
1456,2,0,1458,0.41,1
1483,11,24,1518,0.59,1
1458,-4,-3,1451,0.43,0
1481,1,21,1503,0.57,1
1459,2,0,1461,0.37,0
1544,-11,24,1557,0.63,1
1462,-7,0,1455,0.39,0
1542,-36,24,1530,0.61,1
1464,4,-2,1466,0.39,1
1540,-21,24,1543,0.61,1
1455,8,0,1463,0.47,1
1463,-2,24,1485,0.53,1
1454,-5,0,1449,0.46,0
1464,-10,24,1478,0.54,0
1457,4,2,1463,0.48,1
1462,-11,26,1477,0.52,1
1458,3,-2,1459,0.48,0
1460,-11,24,1473,0.52,1
1596,2,0,1598,0.66,0
1459,-1,24,1482,0.34,0
1595,8,0,1603,0.66,1
1460,4,24,1488,0.34,1
1592,-28,-2,1562,0.62,1
1462,-7,21,1476,0.38,0
1458,-11,0,1447,0.32,1
1547,7,24,1578,0.68,0
1460,-9,0,1451,0.34,0
1546,-1,24,1569,0.66,1
1461,-6,-1,1454,0.35,0
1544,-8,26,1562,0.65,1
1460,2,0,1462,0.39,1
1495,22,24,1541,0.61,1
1462,-10,0,1452,0.45,0
1494,-29,24,1489,0.55,1
1463,-7,-3,1453,0.39,0
1492,18,24,1534,0.61,1
1553,46,0,1599,0.66,1
1465,-8,24,1481,0.34,0
1556,1,0,1557,0.61,1
1462,-6,24,1480,0.39,1
1554,-11,-3,1540,0.57,1
1463,3,24,1490,0.43,0
1533,-32,0,1501,0.53,1
1465,-10,24,1479,0.47,0
1536,-19,0,1517,0.56,0
1462,-9,24,1477,0.44,1
1534,-18,0,1516,0.56,1
1464,-12,22,1474,0.44,0
1464,-9,0,1455,0.36,1
1527,5,24,1556,0.64,1
1462,5,0,1467,0.38,1
1530,1,24,1555,0.62,0
1463,-11,-3,1449,0.39,0
1529,-25,20,1524,0.61,0
1464,-6,0,1458,0.45,1
1467,4,24,1495,0.55,1
1465,-15,0,1450,0.45,0
1466,-2,24,1488,0.55,1
1462,-14,-1,1447,0.42,1
1469,7,26,1502,0.58,0
1459,2,0,1461,0.38,1
1529,-10,24,1543,0.62,1
1460,-9,0,1451,0.34,0
1528,16,24,1568,0.66,1
1455,-4,-4,1447,0.35,1
1533,-5,26,1554,0.65,1
1493,1,0,1494,0.54,0
1456,-16,24,1464,0.46,0
1492,16,0,1508,0.56,0
1457,-14,24,1467,0.44,0
1491,21,-1,1511,0.53,1
1459,4,26,1489,0.47,0
1528,16,0,1544,0.59,1
1461,-5,24,1480,0.41,0
1527,-6,0,1521,0.55,1
1463,-3,24,1484,0.45,0
1524,-29,-2,1493,0.52,1
1465,-11,24,1478,0.48,0
1455,-34,0,1421,0.41,1
1466,-5,24,1485,0.59,0
1452,14,0,1466,0.48,1
1470,-12,24,1482,0.52,0
1453,1,0,1454,0.47,0
1469,-17,24,1476,0.53,0
1455,3,0,1458,0.46,0
1467,-3,24,1488,0.54,1
1468,-14,0,1454,0.48,0
1448,-2,24,1470,0.52,1
1469,-2,0,1467,0.5,1
1446,0,24,1470,0.5,1
1467,-13,0,1454,0.48,1
1449,-6,24,1467,0.52,0
1469,-8,-2,1459,0.48,1
1447,0,24,1471,0.52,1
1467,-10,0,1457,0.32,0
1550,17,24,1591,0.68,0
1470,-10,0,1460,0.39,1
1547,-30,24,1541,0.61,1
1465,-10,-3,1452,0.35,1
1552,-14,24,1562,0.65,0
1526,-26,0,1500,0.54,0
1464,-15,24,1473,0.46,1
1524,7,0,1531,0.56,1
1466,-4,24,1486,0.44,0
1522,30,0,1552,0.6,1
1467,-7,24,1484,0.4,0
1520,-33,-2,1485,0.5,1
1469,-11,24,1482,0.5,0
1470,6,0,1476,0.38,1
1531,7,24,1562,0.62,1
1468,-7,0,1461,0.4,1
1533,-29,24,1528,0.6,1
1469,23,-1,1491,0.44,1
1532,-26,24,1530,0.56,1
1466,-17,0,1449,0.43,1
1466,5,24,1495,0.57,0
1464,5,-1,1468,0.48,1
1467,-6,22,1483,0.52,0
1500,-26,0,1474,0.49,1
1463,-6,24,1481,0.51,1
1501,2,0,1503,0.54,0
1461,-9,24,1476,0.46,0
1502,-13,0,1489,0.46,1
1461,29,24,1514,0.54,1
1504,-23,-3,1478,0.49,0
1459,3,24,1486,0.51,1
1481,-16,0,1465,0.51,0
1458,-20,24,1462,0.49,0
1482,-28,0,1454,0.47,1
1457,-5,24,1476,0.53,1
1483,11,-2,1492,0.53,1
1456,-5,21,1472,0.47,1
1454,26,0,1480,0.4,0
1522,3,24,1549,0.6,0
1455,1,0,1456,0.34,0
1522,24,24,1570,0.66,1
1455,-24,-1,1430,0.33,0
1521,9,21,1551,0.67,0
1457,-2,0,1455,0.42,0
1497,-7,24,1514,0.58,1
1458,-7,0,1451,0.37,0
1496,24,24,1544,0.63,0
1455,26,-4,1477,0.44,1
1499,-2,21,1518,0.56,0
1456,2,0,1458,0.36,0
1517,21,24,1562,0.64,1
1453,-26,0,1427,0.31,1
1519,20,24,1563,0.69,0
1451,-1,0,1450,0.34,1
1522,18,24,1564,0.66,0
1448,-8,-3,1437,0.35,1
1524,-1,24,1547,0.65,0
1452,-17,0,1435,0.41,0
1446,26,24,1496,0.59,1
1451,2,1,1454,0.47,0
1448,2,26,1476,0.53,0
1529,6,0,1535,0.59,0
1446,0,24,1470,0.41,0
1528,10,0,1538,0.61,1
1447,-12,24,1459,0.39,1
1530,-24,-2,1504,0.57,0
1446,-12,22,1456,0.43,0
1442,24,0,1466,0.32,1
1557,12,24,1593,0.68,0
1442,-11,0,1431,0.29,1
1556,5,24,1585,0.71,1
1441,1,0,1442,0.34,1
1558,-27,24,1555,0.66,1
1442,-8,-3,1431,0.27,0
1556,24,22,1602,0.73,1
1440,-15,0,1425,0.42,1
1450,8,24,1482,0.58,1
1439,22,0,1461,0.49,1
1451,-6,24,1469,0.51,1
1441,-6,0,1435,0.45,0
1449,-3,24,1470,0.55,1
1442,5,-1,1446,0.47,1
1448,-7,24,1465,0.53,1
1476,-6,-1,1469,0.52,0
1440,-10,26,1456,0.48,1
1502,-15,0,1487,0.56,0
1441,-17,24,1448,0.44,0
1503,10,0,1513,0.54,1
1439,22,24,1485,0.46,1
1502,25,0,1527,0.6,1
1441,-6,24,1459,0.4,0
1493,-5,0,1488,0.52,1
1442,7,24,1473,0.48,1
1496,24,0,1520,0.6,0
1438,-13,24,1449,0.4,1
1493,-12,-2,1479,0.52,1
1441,0,22,1463,0.48,0
1437,13,0,1450,0.36,1
1532,-5,24,1551,0.64,0
1439,1,0,1440,0.34,0
1530,3,24,1557,0.66,1
1437,-4,0,1433,0.37,1
1532,-30,24,1526,0.63,0
1438,8,0,1446,0.34,0
1531,4,24,1559,0.66,1
1435,-5,0,1430,0.36,1
1534,-24,21,1531,0.64,1
1436,8,0,1444,0.35,0
1568,-39,24,1553,0.65,0
1437,2,0,1439,0.31,1
1567,-10,24,1581,0.69,1
1434,6,-2,1438,0.27,1
1569,16,24,1609,0.73,1
1531,3,0,1534,0.65,1
1433,-27,24,1430,0.35,1
1530,-7,0,1523,0.6,1
1435,-3,24,1456,0.4,0
1531,-46,-1,1484,0.53,1
1433,5,24,1462,0.47,1
1575,-7,0,1568,0.65,1
1431,3,24,1458,0.35,1
1575,16,0,1591,0.68,0
1431,1,24,1456,0.32,0
1574,-4,0,1570,0.69,1
1432,-27,24,1429,0.31,1
1573,-2,-3,1568,0.66,1
1433,1,22,1456,0.34,0
1435,10,0,1445,0.44,0
1459,6,24,1489,0.56,1
1436,4,0,1440,0.43,0
1457,8,24,1489,0.57,0
1437,0,-2,1435,0.42,0
1456,12,24,1492,0.58,1
1436,-7,0,1429,0.37,0
1507,-11,24,1520,0.63,0
1437,-23,0,1414,0.32,0
1505,16,24,1545,0.68,1
1436,-9,-3,1424,0.39,1
1507,-31,22,1498,0.61,0
1462,-3,0,1459,0.49,0
1433,5,24,1462,0.51,1
1463,-5,0,1458,0.5,0
1432,2,24,1458,0.5,1
1462,14,4,1480,0.52,1
1433,0,29,1462,0.48,1
1523,-4,0,1519,0.62,0
1432,-19,24,1437,0.38,1
1526,-4,0,1522,0.6,1
1429,-4,24,1449,0.4,1
1524,22,0,1546,0.63,1
1430,0,24,1454,0.37,0
1524,-10,-3,1511,0.58,0
1431,0,24,1455,0.42,0
1526,-18,0,1508,0.58,1
1429,-2,24,1451,0.42,1
1528,12,0,1540,0.66,0
1427,-23,24,1428,0.34,0
1527,-8,-2,1517,0.6,0
1428,-4,22,1446,0.4,0
1429,2,0,1431,0.3,1
1557,-4,24,1577,0.7,1
1430,-3,0,1427,0.3,0
1556,-5,24,1575,0.7,1
1431,4,-2,1433,0.29,1
1555,5,26,1586,0.71,1
1432,11,0,1443,0.39,1
1519,-23,24,1520,0.61,1
1430,-25,0,1405,0.3,1
1520,11,24,1555,0.7,1
1428,-1,-2,1425,0.37,1
1522,-27,23,1518,0.63,0
1430,-1,0,1429,0.44,1
1465,-18,24,1471,0.56,1
1428,0,0,1428,0.43,0
1466,-12,24,1478,0.57,0
1429,10,0,1439,0.44,0
1465,-12,24,1477,0.56,0
1430,-31,-4,1395,0.33,0
1464,36,20,1520,0.67,1
1555,-5,0,1550,0.64,0
1427,-5,24,1446,0.36,1
1554,-2,0,1552,0.64,1
1428,-3,24,1449,0.36,0
1555,-7,-2,1546,0.63,0
1427,0,26,1453,0.37,0
1536,31,0,1567,0.63,1
1428,24,24,1476,0.37,0
1536,-12,0,1524,0.64,1
1429,-28,24,1425,0.36,1
1538,-15,-3,1520,0.61,0
1427,-8,21,1440,0.39,0
1428,-2,0,1426,0.31,0
1533,10,24,1567,0.69,1
1429,4,0,1433,0.31,0
1532,12,24,1568,0.69,1
1430,24,-3,1451,0.34,0
1531,14,24,1569,0.66,0
1459,22,0,1481,0.37,0
1529,21,24,1574,0.63,0
1460,-6,0,1454,0.37,0
1528,-3,24,1549,0.63,1
1461,0,0,1461,0.36,0
1527,15,21,1563,0.64,1
1529,1,0,1530,0.56,1
1459,8,24,1491,0.44,1
1531,22,0,1553,0.61,1
1456,-1,24,1479,0.39,1
1533,20,0,1553,0.62,0
1455,-9,24,1470,0.38,1
1532,-6,-3,1523,0.6,1
1456,-22,21,1455,0.4,1
1511,-12,0,1499,0.44,1
1536,-16,24,1544,0.56,0
1509,25,0,1534,0.45,0
1538,10,24,1572,0.55,0
1511,-20,0,1491,0.4,0
1537,-2,24,1559,0.6,1
1512,20,-2,1530,0.43,0
1536,19,26,1581,0.57,0
1502,13,0,1515,0.4,1
1538,24,24,1586,0.6,0
1499,-9,-3,1487,0.39,1
1542,-1,23,1564,0.61,0
1540,-18,0,1522,0.36,1
1593,4,24,1621,0.64,0
1542,12,0,1554,0.43,0
1591,-15,24,1600,0.57,1
1543,-5,0,1538,0.38,0
1590,12,24,1626,0.62,1
1544,17,-2,1559,0.47,0
1588,-28,21,1581,0.53,0
1543,19,0,1562,0.61,1
1462,-3,24,1483,0.39,0
1544,-1,0,1543,0.54,1
1461,26,26,1513,0.46,1
1529,-11,0,1518,0.41,1
1546,15,24,1585,0.59,1
1527,-19,0,1508,0.41,1
1548,-1,24,1571,0.59,0
1528,24,0,1552,0.5,0
1547,-20,24,1551,0.5,0
1526,-13,-3,1510,0.38,1
1549,23,24,1596,0.62,0
1464,-1,0,1463,0.32,1
1548,21,24,1593,0.68,1
1465,24,0,1489,0.39,0
1547,-2,24,1569,0.61,0
1466,-8,-2,1456,0.33,0
1546,11,21,1578,0.67,1
1549,-1,0,1548,0.59,0
1455,5,24,1484,0.41,1
1550,-42,0,1508,0.54,1
1454,1,24,1479,0.46,1
1553,-9,-3,1541,0.58,1
1451,11,24,1486,0.42,1
1552,19,0,1571,0.63,1
1462,-11,24,1475,0.37,1
1548,-65,0,1483,0.5,1
1466,-4,24,1486,0.5,1
1546,0,0,1546,0.58,1
1468,-6,24,1486,0.42,1
1544,3,-4,1543,0.58,1
1469,-3,21,1487,0.42,0
1452,-1,0,1451,0.34,1
1546,-4,24,1566,0.66,0
1449,10,0,1459,0.34,1
1549,3,24,1576,0.66,0
1450,-14,0,1436,0.38,0
1548,-49,24,1523,0.62,0
1452,2,-2,1452,0.31,0
1547,15,26,1588,0.69,1
1548,4,0,1552,0.48,0
1543,-2,24,1565,0.52,1
1550,-17,0,1533,0.46,0
1541,-2,24,1563,0.54,1
1548,-9,-1,1538,0.46,1
1543,0,20,1563,0.54,1
1542,18,0,1560,0.5,1
1541,-5,24,1560,0.5,1
1540,-2,0,1538,0.5,1
1543,-30,24,1537,0.5,0
1537,11,0,1548,0.41,1
1546,39,24,1609,0.59,0
1538,-2,-2,1534,0.48,1
1545,-22,23,1546,0.52,1
1539,0,0,1539,0.5,0
1513,0,24,1537,0.5,1
1540,1,0,1541,0.48,0
1512,22,24,1558,0.52,0
1542,-45,-4,1493,0.49,0
1511,-33,24,1502,0.51,1
1436,11,0,1447,0.35,0
1541,-8,24,1557,0.65,1
1434,5,0,1439,0.31,1
1543,12,24,1579,0.69,0
1435,10,-2,1443,0.33,0
1543,-1,26,1568,0.67,1
1544,-45,0,1499,0.4,0
1544,-1,24,1567,0.6,0
1542,33,0,1575,0.5,1
1546,2,24,1572,0.5,0
1543,-17,-4,1522,0.5,0
1545,-45,22,1522,0.5,0
1541,-13,0,1528,0.48,1
1523,-4,24,1543,0.52,0
1540,11,0,1551,0.48,0
1524,20,24,1568,0.52,0
1539,2,-4,1537,0.52,1
1525,-24,23,1524,0.48,1
1538,-4,0,1534,0.5,0
1524,-13,24,1535,0.5,0
1539,6,0,1545,0.46,0
1523,24,24,1571,0.54,0
1538,21,-1,1558,0.54,0
1524,-18,22,1528,0.46,0
1536,12,0,1548,0.51,1
1541,-25,24,1540,0.49,0
1537,2,0,1539,0.45,1
1540,9,24,1573,0.55,1
1534,-1,-2,1531,0.4,1
1543,30,26,1599,0.6,1
1475,-14,0,1461,0.42,1
1536,-42,24,1518,0.58,1
1475,0,0,1475,0.35,1
1535,24,24,1583,0.65,1
1472,-6,-4,1462,0.38,1
1538,-12,24,1550,0.62,0
1493,1,0,1494,0.39,0
1538,10,24,1572,0.61,0
1489,17,0,1506,0.41,1
1541,1,24,1566,0.59,0
1490,18,0,1508,0.42,0
1540,-3,24,1561,0.58,0
1491,-18,-4,1469,0.44,0
1539,-47,20,1512,0.56,0
1541,-15,0,1526,0.5,1
1495,4,24,1523,0.5,1
1540,26,3,1569,0.58,1
1496,-9,25,1512,0.42,1
1539,8,0,1547,0.62,1
1442,-5,24,1461,0.38,0
1540,2,0,1542,0.61,1
1440,3,24,1467,0.39,1
1538,-1,-2,1535,0.6,1
1442,0,24,1466,0.4,0
1537,-49,0,1488,0.45,1
1483,16,24,1523,0.55,1
1535,-19,0,1516,0.53,1
1484,-11,24,1497,0.47,1
1534,10,-2,1542,0.56,1
1486,-13,26,1499,0.44,1
1589,12,0,1601,0.55,1
1537,8,24,1569,0.45,0
1590,-27,0,1563,0.51,0
1535,-6,24,1553,0.49,0
1589,4,1,1594,0.61,1
1537,-49,26,1514,0.39,0
1490,-11,0,1479,0.42,0
1535,-25,24,1534,0.58,1
1491,-8,0,1483,0.38,0
1534,9,24,1567,0.62,1
1492,-17,-1,1474,0.37,0
1532,10,24,1566,0.63,1
1548,-29,0,1519,0.46,0
1531,-9,24,1546,0.54,0
1546,0,0,1546,0.55,1
1533,-44,24,1513,0.45,0
1544,-38,0,1506,0.46,1
1535,-28,24,1531,0.54,0
1548,22,-4,1566,0.51,0
1531,5,22,1558,0.49,1
1532,9,0,1541,0.47,0
1520,17,24,1561,0.53,0
1536,0,0,1536,0.51,0
1517,-11,24,1530,0.49,1
1534,-49,-3,1482,0.42,1
1518,-7,24,1535,0.58,0
1533,5,0,1538,0.61,1
1458,-23,24,1459,0.39,1
1531,2,0,1533,0.61,1
1459,-29,24,1454,0.39,0
1530,1,0,1531,0.55,0
1461,11,24,1496,0.45,0
1531,-1,-2,1528,0.56,0
1459,3,24,1486,0.44,1
1535,22,0,1557,0.58,1
1493,-16,24,1501,0.42,0
1532,-12,0,1520,0.54,1
1496,-29,24,1491,0.46,0
1531,-17,-1,1513,0.42,0
1497,46,24,1567,0.58,0
1533,33,0,1566,0.51,0
1536,-2,24,1558,0.49,1
1534,-37,-3,1494,0.42,0
1535,-4,22,1553,0.58,1
1536,23,0,1559,0.51,0
1510,22,24,1556,0.49,1
1537,-43,0,1494,0.47,0
1509,-15,24,1518,0.53,1
1536,-24,0,1512,0.47,0
1510,-4,24,1530,0.53,0
1535,32,-3,1564,0.51,0
1512,25,22,1559,0.49,0
1446,-17,0,1429,0.38,0
1534,-43,24,1515,0.62,1
1445,9,0,1454,0.32,0
1536,25,24,1585,0.68,0
1447,6,-2,1451,0.4,0
1533,-40,26,1519,0.6,1
1517,26,0,1543,0.44,0
1531,30,24,1585,0.56,1
1515,-19,0,1496,0.44,1
1532,-15,24,1541,0.56,1
1517,24,-1,1540,0.54,0
1531,-44,24,1511,0.46,1
1556,-10,0,1546,0.46,1
1528,26,24,1578,0.54,1
1554,-17,0,1537,0.49,1
1530,-12,24,1542,0.51,0
1553,7,-1,1559,0.47,1
1531,29,22,1582,0.53,0
1529,-11,0,1518,0.41,1
1546,15,24,1585,0.59,1
1527,-19,0,1508,0.41,1
1548,-1,24,1571,0.59,0
1528,24,0,1552,0.5,0
1547,-20,24,1551,0.5,0
1526,-13,-3,1510,0.38,1
1549,23,24,1596,0.62,0
1527,32,0,1559,0.56,0
1480,15,24,1519,0.44,1
1530,-11,-1,1518,0.5,0
1478,16,23,1517,0.5,1
1533,-16,0,1517,0.57,0
1448,-6,24,1466,0.43,1
1532,18,0,1550,0.6,0
1449,7,24,1480,0.4,0
1531,-46,0,1485,0.5,1
1450,13,24,1487,0.5,1
1530,-13,0,1517,0.58,1
1451,-13,24,1462,0.42,0
1527,30,-2,1555,0.62,1
1453,-8,24,1469,0.38,0
1499,-34,0,1465,0.4,0
1526,-14,24,1536,0.6,0
1497,-11,0,1486,0.42,1
1528,-13,24,1539,0.58,1
1498,39,-3,1534,0.45,0
1527,16,24,1567,0.55,0
1460,-12,0,1448,0.36,1
1532,-9,24,1547,0.64,0
1461,1,0,1462,0.33,0
1531,27,24,1582,0.67,1
1462,28,-2,1488,0.43,1
1530,-13,21,1538,0.57,1
1527,-12,0,1515,0.39,1
1535,33,24,1592,0.61,0
1524,12,0,1536,0.49,1
1538,-20,24,1542,0.51,0
1523,-10,-1,1512,0.47,0
1539,-36,26,1529,0.53,0
1514,6,0,1520,0.48,1
1521,-8,24,1537,0.52,1
1516,11,0,1527,0.44,0
1519,27,24,1570,0.56,1
1519,-15,-1,1503,0.47,0
1516,-16,26,1526,0.53,1
1520,15,0,1535,0.48,1
1515,14,24,1553,0.52,1
1519,-21,0,1498,0.45,1
1517,-9,24,1532,0.55,1
1517,18,-2,1533,0.5,1
1518,-9,23,1532,0.5,1
1519,30,0,1549,0.48,1
1539,2,24,1565,0.52,1
1521,-12,0,1509,0.45,0
1536,-17,24,1543,0.55,1
1522,-38,-3,1481,0.41,1
1535,-11,22,1546,0.59,1
1521,7,0,1528,0.47,1
1541,-17,24,1548,0.53,0
1522,-6,0,1516,0.42,1
1539,9,24,1572,0.58,1
1523,-12,0,1511,0.39,1
1539,24,24,1587,0.61,1
1521,27,-3,1545,0.51,1
1540,-27,21,1534,0.49,0
1594,-1,0,1593,0.59,0
1520,-16,24,1528,0.41,1
1592,-34,0,1558,0.51,1
1521,8,24,1553,0.49,1
1591,0,-2,1589,0.57,1
1523,-4,24,1543,0.43,0
1538,-4,0,1534,0.5,0
1524,-13,24,1535,0.5,0
1539,6,0,1545,0.46,0
1523,24,24,1571,0.54,0
1538,21,-1,1558,0.54,0
1524,-18,22,1528,0.46,0
1525,8,0,1533,0.44,1
1586,-32,24,1578,0.56,1
1522,-2,0,1520,0.36,1
1589,6,24,1619,0.64,0
1520,-5,0,1515,0.34,1
1591,14,24,1629,0.66,1
1518,26,-3,1541,0.44,1
1593,-29,20,1584,0.56,1
1517,-40,0,1477,0.41,1
1498,15,24,1537,0.59,0
1518,10,0,1528,0.47,1
1497,30,24,1551,0.53,1
1514,-7,-4,1503,0.46,1
1501,5,24,1530,0.54,0
1532,10,0,1542,0.56,1
1516,-40,24,1500,0.44,0
1534,30,5,1569,0.55,0
1515,-7,29,1537,0.45,0
1532,-28,-1,1503,0.44,1
1516,7,24,1547,0.56,1
1469,1,0,1470,0.36,0
1517,24,24,1565,0.64,0
1467,12,-1,1478,0.41,1
1519,-1,25,1543,0.59,1
1520,-15,0,1505,0.38,1
1533,33,24,1590,0.62,1
1519,-7,0,1512,0.48,1
1534,-31,24,1527,0.52,0
1520,6,-1,1525,0.49,0
1533,-26,23,1530,0.51,0
1465,-3,0,1462,0.36,0
1519,19,24,1562,0.64,1
1466,-20,0,1446,0.37,0
1517,-1,24,1540,0.63,1
1468,14,0,1482,0.44,0
1515,-17,24,1522,0.56,1
1470,4,-2,1472,0.41,0
1513,-6,24,1531,0.59,1
1538,-14,0,1524,0.48,0
1514,2,24,1540,0.52,0
1537,-15,0,1522,0.44,1
1516,23,24,1563,0.56,0
1538,-5,-1,1532,0.49,0
1515,1,22,1538,0.51,1
1513,-17,0,1496,0.47,1
1473,17,24,1514,0.53,1
1514,-6,0,1508,0.51,1
1472,2,24,1498,0.49,1
1516,1,-4,1513,0.55,0
1470,-12,24,1482,0.45,1
1519,32,0,1551,0.59,0
1486,-21,24,1489,0.41,1
1517,2,0,1519,0.49,1
1489,10,24,1523,0.51,0
1519,-17,0,1502,0.47,0
1487,9,24,1520,0.53,1
1520,-6,-3,1511,0.48,0
1486,17,22,1525,0.52,1
1525,27,0,1552,0.51,1
1522,-1,24,1545,0.49,1
1523,-30,0,1493,0.38,0
1523,30,24,1577,0.62,0
1524,-31,-2,1491,0.41,1
1523,5,24,1552,0.59,1
1453,-17,0,1436,0.37,1
1525,-21,24,1528,0.63,0
1454,-10,0,1444,0.37,0
1524,-13,24,1535,0.63,1
1456,38,-4,1490,0.42,1
1522,1,24,1547,0.58,1
1488,-20,-3,1465,0.49,1
1439,5,28,1472,0.51,0
1436,-22,0,1414,0.4,1
1465,-6,24,1483,0.6,0
1437,-2,0,1435,0.46,0
1463,-21,24,1466,0.54,0
1440,10,-4,1446,0.44,0
1460,4,24,1488,0.56,1
1441,4,0,1445,0.43,0
1497,-27,24,1494,0.57,0
1442,5,0,1447,0.38,1
1496,12,24,1532,0.62,1
1441,-8,0,1433,0.42,0
1497,-34,24,1487,0.58,0
1438,-4,-3,1431,0.39,1
1500,-14,21,1507,0.61,0
1436,14,0,1450,0.36,1
1535,-9,24,1550,0.64,1
1435,7,0,1442,0.31,1
1536,17,24,1577,0.69,0
1435,6,-2,1439,0.38,0
1536,-38,26,1524,0.62,1
1437,-20,0,1417,0.43,0
1462,-21,24,1465,0.57,1
1435,-5,-2,1428,0.42,1
1464,-5,24,1483,0.58,0
1587,4,0,1591,0.68,1
1438,-2,24,1460,0.32,0
1590,-6,0,1584,0.65,0
1435,12,26,1473,0.35,1
1538,16,0,1554,0.62,0
1436,8,24,1468,0.38,0
1540,-34,0,1506,0.6,1
1434,-21,24,1437,0.4,1
1537,43,0,1580,0.65,1
1437,10,24,1471,0.35,0
1538,-19,-3,1516,0.58,1
1436,6,22,1464,0.42,1
1435,1,0,1436,0.43,1
1454,8,24,1486,0.57,1
1436,7,0,1443,0.48,0
1453,-20,24,1457,0.52,0
1437,-8,-3,1426,0.43,0
1452,5,21,1478,0.57,0
1438,9,0,1447,0.31,0
1528,30,24,1582,0.69,1
1438,5,0,1443,0.34,1
1527,7,24,1558,0.66,1
1439,1,-3,1437,0.33,0
1527,5,26,1558,0.67,1
1460,3,0,1463,0.49,1
1438,5,24,1467,0.51,1
1457,-9,0,1448,0.5,1
1441,-16,24,1449,0.5,1
1459,-14,0,1445,0.46,0
1439,7,24,1470,0.54,1
1462,-10,-2,1450,0.48,0
1435,2,24,1461,0.52,1
1527,-16,0,1511,0.58,0
1434,-2,24,1456,0.42,1
1526,-6,0,1520,0.58,1
1435,6,24,1465,0.42,1
1525,15,-2,1538,0.6,0
1436,10,23,1469,0.4,0
1434,13,0,1447,0.35,1
1517,15,24,1556,0.65,1
1436,-17,0,1419,0.31,0
1516,14,24,1554,0.69,1
1437,1,0,1438,0.39,0
1515,-24,24,1515,0.61,0
1438,-5,-2,1431,0.37,1
1514,-18,24,1520,0.63,1
1438,6,0,1444,0.33,0
1549,-9,24,1564,0.67,1
1440,7,0,1447,0.33,1
1548,0,24,1572,0.67,1
1441,15,0,1456,0.37,0
1547,-25,24,1546,0.63,1
1441,-2,-2,1437,0.28,0
1546,29,24,1599,0.72,0
1463,-7,0,1456,0.5,0
1443,-8,24,1459,0.5,0
1461,-10,0,1451,0.46,1
1444,10,26,1480,0.54,0
1464,28,0,1492,0.53,0
1443,5,24,1472,0.47,0
1465,-24,0,1441,0.45,0
1442,11,24,1477,0.55,0
1463,10,-2,1471,0.5,1
1443,5,22,1470,0.5,1
1440,10,0,1450,0.31,1
1595,-33,24,1586,0.69,1
1437,-10,0,1427,0.24,1
1598,3,24,1625,0.76,0
1435,4,-1,1438,0.25,1
1600,5,22,1627,0.75,1
1436,11,0,1447,0.35,0
1541,-8,24,1557,0.65,1
1434,5,0,1439,0.31,1
1543,12,24,1579,0.69,0
1435,10,-2,1443,0.33,0
1543,-1,26,1568,0.67,1
1460,-27,0,1433,0.45,1
1433,8,24,1465,0.55,1
1459,5,0,1464,0.5,0
1434,6,24,1464,0.5,0
1460,-5,-3,1452,0.49,0
1433,3,24,1460,0.51,0
1508,-10,0,1498,0.57,1
1436,-10,24,1450,0.43,1
1507,-19,0,1488,0.52,1
1437,12,24,1473,0.48,1
1506,25,-2,1529,0.59,1
1438,6,24,1468,0.41,0
1437,-11,0,1426,0.39,0
1483,-6,24,1501,0.61,0
1439,2,0,1441,0.44,0
1481,-18,24,1487,0.56,1
1442,-1,-2,1439,0.42,0
1478,-4,20,1494,0.58,1
1478,-19,0,1459,0.48,0
1441,7,24,1472,0.52,0
1479,34,0,1513,0.57,0
1439,2,24,1465,0.43,0
1477,17,0,1494,0.55,1
1441,-7,24,1458,0.45,0
1475,4,-2,1477,0.51,1
1443,3,24,1470,0.49,0
1595,-37,0,1558,0.63,0
1441,-2,24,1463,0.37,1
1593,-9,0,1584,0.67,1
1443,-6,24,1461,0.33,0
1596,6,-2,1600,0.68,0
1440,3,22,1465,0.32,1
1442,-2,0,1440,0.4,0
1470,17,24,1511,0.6,1
1440,-2,0,1438,0.45,1
1472,-23,24,1473,0.55,1
1442,1,3,1446,0.43,0
1470,1,24,1495,0.57,1
1440,3,0,1443,0.45,1
1467,-16,24,1475,0.55,0
1440,-2,3,1441,0.42,0
1466,9,25,1500,0.58,0
1539,8,0,1547,0.62,1
1442,-5,24,1461,0.38,0
1540,2,0,1542,0.61,1
1440,3,24,1467,0.39,1
1538,-1,-2,1535,0.6,1
1442,0,24,1466,0.4,0
1540,-5,0,1535,0.6,0
1443,1,24,1468,0.4,0
1539,-42,0,1497,0.55,0
1444,-2,24,1466,0.45,0
1538,13,-2,1549,0.61,1
1445,-2,24,1467,0.39,1
1444,3,0,1447,0.42,1
1483,-7,24,1500,0.58,0
1449,11,0,1460,0.44,0
1478,-3,24,1499,0.56,1
1447,-2,0,1445,0.41,1
1480,2,24,1506,0.59,0
1446,0,-1,1445,0.45,1
1481,-26,24,1479,0.55,0
1447,-7,0,1440,0.32,0
1537,12,24,1573,0.68,1
1447,1,0,1448,0.3,0
1537,35,24,1596,0.7,1
1449,18,-2,1465,0.39,0
1535,-14,24,1545,0.61,1
1468,-14,0,1454,0.48,0
1448,-2,24,1470,0.52,1
1469,-2,0,1467,0.5,1
1446,0,24,1470,0.5,1
1467,-13,0,1454,0.48,1
1449,-6,24,1467,0.52,0
1469,-8,-2,1459,0.48,1
1447,0,24,1471,0.52,1
1484,-2,0,1482,0.49,0
1445,19,24,1488,0.51,1
1483,-9,0,1474,0.51,0
1446,-4,23,1465,0.49,0
1443,0,0,1443,0.38,1
1505,-2,24,1527,0.62,1
1444,-5,2,1441,0.37,0
1503,3,26,1532,0.63,1
1446,2,-3,1445,0.35,0
1501,28,24,1553,0.65,1
1475,24,4,1503,0.46,1
1491,11,31,1533,0.54,0
1517,-4,0,1513,0.54,1
1477,-14,24,1487,0.46,0
1516,8,0,1524,0.57,0
1477,-28,24,1473,0.43,0
1514,30,0,1544,0.56,1
1479,0,24,1503,0.44,0
1513,0,-3,1510,0.49,1
1480,14,24,1518,0.51,1
1433,-1,0,1432,0.37,0
1479,19,24,1522,0.63,1
1429,-5,0,1424,0.4,1
1482,-12,24,1494,0.6,1
1430,-16,-4,1410,0.4,1
1482,-27,24,1479,0.6,1
1522,-8,0,1514,0.5,1
1483,9,24,1516,0.5,1
1523,1,0,1524,0.5,1
1481,17,24,1522,0.5,1
1525,22,-1,1546,0.53,1
1480,20,23,1523,0.47,1
1481,-16,0,1465,0.51,0
1458,-20,24,1462,0.49,0
1482,-28,0,1454,0.47,1
1457,-5,24,1476,0.53,1
1483,11,-2,1492,0.53,1
1456,-5,21,1472,0.47,1
1485,21,0,1506,0.44,0
1540,-18,24,1546,0.56,1
1482,17,0,1499,0.45,1
1543,-29,24,1538,0.55,0
1483,-14,-1,1468,0.38,0
1542,-16,26,1552,0.62,1
1484,10,0,1494,0.52,0
1445,10,24,1479,0.48,0
1482,17,0,1499,0.53,1
1447,4,24,1475,0.47,0
1480,19,-2,1497,0.54,1
1449,-7,24,1466,0.46,1
1451,-4,0,1447,0.43,1
1482,-8,24,1498,0.57,1
1452,10,0,1462,0.47,0
1481,-23,24,1482,0.53,0
1450,10,-1,1459,0.42,0
1482,8,26,1516,0.58,0
1527,32,0,1559,0.56,0
1480,15,24,1519,0.44,1
1530,-11,-1,1518,0.5,0
1478,16,23,1517,0.5,1
1480,14,0,1494,0.57,0
1454,-35,24,1443,0.43,1
1483,-15,0,1468,0.52,1
1451,-22,24,1453,0.48,1
1480,10,0,1490,0.49,1
1454,20,24,1498,0.51,0
1479,13,-3,1489,0.53,0
1455,-9,24,1470,0.47,0
1545,-6,0,1539,0.58,1
1481,-23,24,1482,0.42,0
1544,-22,0,1522,0.51,1
1482,8,24,1514,0.49,0
1546,-1,-2,1543,0.58,0
1480,-14,21,1487,0.42,1
1479,7,0,1486,0.39,1
1520,22,24,1566,0.61,1
1477,21,0,1498,0.41,1
1522,15,24,1561,0.59,1
1479,1,0,1480,0.44,0
1520,-19,24,1525,0.56,1
1480,11,0,1491,0.41,0
1502,29,24,1555,0.59,1
1479,-18,0,1461,0.44,1
1504,-27,24,1501,0.56,0
1480,8,-1,1487,0.44,0
1503,5,24,1532,0.56,1
1494,-4,0,1490,0.45,1
1481,19,24,1524,0.55,1
1495,0,0,1495,0.5,0
1480,-10,24,1494,0.5,0
1494,20,-3,1511,0.5,1
1481,7,24,1512,0.5,0
1529,4,0,1533,0.56,0
1482,-16,24,1490,0.44,0
1528,1,0,1529,0.52,1
1483,5,24,1512,0.48,0
1529,-16,0,1513,0.49,0
1482,16,24,1522,0.51,0
1532,14,-3,1543,0.58,1
1479,-11,20,1488,0.42,1
1481,12,0,1493,0.53,1
1448,-3,24,1469,0.47,1
1478,-13,0,1465,0.51,1
1451,-15,24,1460,0.49,1
1476,9,0,1485,0.52,1
1452,-8,24,1468,0.48,1
1474,13,-2,1485,0.46,1
1454,35,21,1510,0.54,0
1471,-18,0,1453,0.37,1
1532,-11,24,1545,0.63,0
1473,16,-1,1488,0.4,0
1531,-2,26,1555,0.6,1
1474,-11,0,1463,0.36,0
1553,-14,24,1563,0.64,1
1474,8,0,1482,0.31,0
1553,46,24,1623,0.69,0
1472,8,0,1480,0.37,0
1555,-4,24,1575,0.63,0
1473,-19,-2,1452,0.34,0
1554,-6,20,1568,0.66,1
1532,26,0,1558,0.57,1
1472,16,24,1512,0.43,1
1535,-6,0,1529,0.56,1
1469,-7,24,1486,0.44,1
1536,5,-4,1537,0.55,1
1468,9,24,1501,0.45,1
1523,-33,0,1490,0.49,0
1465,5,24,1494,0.51,1
1521,-4,0,1517,0.55,1
1468,-7,24,1485,0.45,0
1518,-14,-1,1503,0.49,1
1470,16,24,1510,0.51,0
1461,-5,0,1456,0.46,0
1469,-12,24,1481,0.54,0
1458,-5,0,1453,0.44,1
1472,0,24,1496,0.56,0
1460,15,-3,1472,0.47,1
1471,2,21,1494,0.53,1
1471,8,0,1479,0.35,0
1564,-2,24,1586,0.65,0
1469,-7,0,1462,0.33,1
1566,-3,24,1587,0.67,0
1470,15,6,1491,0.33,0
1566,17,29,1612,0.67,0
1469,1,0,1470,0.36,0
1517,24,24,1565,0.64,0
1467,12,-1,1478,0.41,1
1519,-1,25,1543,0.59,1
1544,-18,0,1526,0.57,0
1465,-13,24,1476,0.43,1
1545,-32,0,1513,0.52,0
1463,10,24,1497,0.48,0
1544,-1,-3,1540,0.57,1
1465,-1,24,1488,0.43,0
1539,44,0,1583,0.64,0
1465,-4,24,1485,0.36,0
1538,6,0,1544,0.58,1
1466,-5,24,1485,0.42,0
1536,-21,0,1515,0.55,1
1468,-11,24,1481,0.45,0
1538,-9,-2,1527,0.55,0
1466,10,20,1496,0.45,1
1467,-9,0,1458,0.48,0
1461,-12,24,1473,0.52,0
1465,-8,0,1457,0.41,0
1463,37,24,1524,0.59,0
1462,-9,-3,1450,0.48,1
1466,-24,24,1466,0.52,0
1460,-2,0,1458,0.39,1
1507,8,24,1539,0.61,1
1462,13,0,1475,0.41,0
1505,8,24,1537,0.59,1
1463,19,-2,1480,0.39,0
1504,30,26,1560,0.61,1
1517,-21,0,1496,0.52,1
1465,-9,24,1480,0.48,0
1515,10,0,1525,0.55,1
1467,-3,24,1488,0.45,0
1513,-24,0,1489,0.5,1
1468,-5,24,1487,0.5,1
1516,26,-1,1541,0.55,1
1466,13,26,1505,0.45,1
1469,-16,0,1453,0.46,1
1468,-8,24,1484,0.54,0
1467,-6,-3,1458,0.46,1
1469,-5,21,1485,0.54,1
1466,-13,0,1453,0.34,1
1555,-9,24,1570,0.66,1
1466,13,0,1479,0.35,0
1554,11,24,1589,0.65,1
1467,18,-3,1482,0.34,1
1553,22,24,1599,0.66,1
1470,6,0,1476,0.38,1
1531,7,24,1562,0.62,1
1468,-7,0,1461,0.4,1
1533,-29,24,1528,0.6,1
1469,23,-1,1491,0.44,1
1532,-26,24,1530,0.56,1
1536,-24,0,1512,0.44,1
1531,0,24,1555,0.56,1
1538,-24,0,1514,0.39,0
1530,37,24,1591,0.61,1
1539,12,0,1551,0.49,0
1529,5,24,1558,0.51,0
1541,-29,-3,1509,0.44,1
1527,2,21,1550,0.56,1
1530,-5,0,1525,0.56,1
1466,-7,24,1483,0.44,1
1531,-1,0,1530,0.57,1
1465,-9,24,1480,0.43,1
1532,36,-1,1567,0.57,0
1464,33,24,1521,0.43,0
1530,0,0,1530,0.49,1
1542,-30,24,1536,0.51,0
1527,-1,0,1526,0.42,1
1545,12,24,1581,0.58,1
1529,3,-2,1530,0.46,0
1543,-6,21,1558,0.54,1
1527,-8,0,1519,0.43,1
1547,0,24,1571,0.57,0
1524,0,0,1524,0.46,1
1550,-24,24,1550,0.54,1
1522,33,0,1555,0.45,1
1552,15,24,1591,0.55,0
1524,5,0,1529,0.45,0
1550,-9,24,1565,0.55,1
1526,3,-3,1526,0.48,0
1548,-32,24,1540,0.52,1
1537,-12,0,1525,0.46,1
1527,3,24,1554,0.54,0
1536,11,-1,1546,0.5,1
1529,-13,26,1542,0.5,0
1438,9,0,1447,0.31,0
1528,30,24,1582,0.69,1
1438,5,0,1443,0.34,1
1527,7,24,1558,0.66,1
1439,1,-3,1437,0.33,0
1527,5,26,1558,0.67,1
1588,-3,0,1585,0.57,1
1528,-14,24,1538,0.43,1
1589,2,0,1591,0.55,1
1527,2,24,1553,0.45,1
1588,7,-3,1592,0.52,1
1528,29,21,1578,0.48,0
1529,6,0,1535,0.59,0
1446,0,24,1470,0.41,0
1528,10,0,1538,0.61,1
1447,-12,24,1459,0.39,1
1530,-24,-2,1504,0.57,0
1446,-12,22,1456,0.43,0
1531,2,0,1533,0.47,0
1583,-52,24,1555,0.53,0
1531,31,0,1562,0.43,0
1582,3,24,1609,0.57,1
1532,5,-1,1536,0.39,0
1581,6,26,1613,0.61,0
1530,6,0,1536,0.53,1
1522,-29,24,1517,0.47,0
1531,-17,0,1514,0.49,1
1521,-26,24,1519,0.51,1
1533,11,-3,1541,0.48,1
1519,8,24,1551,0.52,1
1514,10,0,1524,0.42,0
1532,26,24,1582,0.58,0
1516,-30,0,1486,0.39,0
1530,6,24,1560,0.61,1
1517,6,-1,1522,0.45,0
1529,1,26,1556,0.55,1
1519,21,0,1540,0.51,1
1530,-17,24,1537,0.49,1
1518,16,0,1534,0.46,0
1531,8,24,1563,0.54,0
1519,-15,-3,1501,0.39,0
1530,25,21,1576,0.61,1
1529,4,0,1533,0.56,0
1482,-16,24,1490,0.44,0
1528,1,0,1529,0.52,1
1483,5,24,1512,0.48,0
1529,-16,0,1513,0.49,0
1482,16,24,1522,0.51,0
1532,14,-3,1543,0.58,1
1479,-11,20,1488,0.42,1
1570,-1,0,1569,0.49,0
1530,24,24,1578,0.51,1
1572,14,0,1586,0.55,0
1529,0,24,1553,0.45,0
1570,-4,0,1566,0.52,0
1530,-1,24,1553,0.48,0
1568,5,-3,1570,0.55,1
1532,-19,24,1537,0.45,0
1491,-20,0,1471,0.36,1
1531,18,24,1573,0.64,1
1493,19,0,1512,0.41,0
1530,23,23,1576,0.59,1
1531,3,0,1534,0.65,1
1433,-27,24,1430,0.35,1
1530,-7,0,1523,0.6,1
1435,-3,24,1456,0.4,0
1531,-46,-1,1484,0.53,1
1433,5,24,1462,0.47,1
1460,12,0,1472,0.36,0
1530,17,24,1571,0.64,1
1462,-17,0,1445,0.32,0
1528,23,24,1575,0.68,1
1460,-16,-3,1441,0.34,0
1530,3,24,1557,0.66,0
1546,24,0,1570,0.54,0
1528,-10,24,1542,0.46,0
1544,-22,0,1522,0.48,1
1530,-17,24,1537,0.52,0
1546,23,-1,1568,0.5,0
1528,17,22,1567,0.5,1
1527,19,0,1546,0.45,1
1534,26,24,1584,0.55,0
1530,15,0,1545,0.51,0
1531,-19,24,1536,0.49,1
1533,-10,-3,1520,0.44,0
1528,9,24,1561,0.56,1
1534,-20,0,1514,0.5,0
1499,-11,24,1512,0.5,0
1532,17,0,1549,0.53,1
1502,1,24,1527,0.47,0
1531,0,0,1531,0.48,1
1503,17,24,1544,0.52,1
1530,18,-3,1545,0.49,1
1504,30,20,1554,0.51,0
1528,12,0,1540,0.54,0
1455,35,24,1514,0.46,0
1527,-14,0,1513,0.56,1
1457,-10,24,1471,0.44,1
1525,14,-4,1535,0.59,1
1458,-10,24,1472,0.41,0
1521,-18,0,1503,0.47,1
1528,-31,24,1521,0.53,0
1517,-5,0,1512,0.41,1
1531,19,24,1574,0.59,0
1519,0,-3,1516,0.44,0
1529,6,24,1559,0.56,1
1510,0,0,1510,0.45,0
1528,-10,24,1542,0.55,0
1511,3,0,1514,0.44,0
1527,8,24,1559,0.56,0
1509,11,-2,1518,0.44,1
1530,0,26,1556,0.56,1
1528,-7,0,1521,0.43,0
1528,19,24,1571,0.57,1
1529,-27,0,1502,0.43,0
1527,0,24,1551,0.57,0
1528,-9,-3,1516,0.43,1
1529,13,23,1565,0.57,0
1526,10,0,1536,0.52,1
1483,18,24,1525,0.48,0
1525,-11,0,1514,0.51,1
1484,-1,24,1507,0.49,1
1527,16,-1,1542,0.56,0
1483,-7,21,1497,0.44,1
1524,-18,0,1506,0.46,1
1545,-34,24,1535,0.54,0
1525,12,0,1537,0.47,0
1545,-9,24,1560,0.53,0
1526,12,-3,1535,0.44,0
1544,11,24,1579,0.56,0
1462,-13,0,1449,0.39,1
1528,-26,24,1526,0.61,0
1460,36,0,1496,0.39,1
1530,16,24,1570,0.61,0
1461,-10,0,1451,0.38,1
1529,-19,24,1534,0.62,1
1455,-26,-3,1426,0.34,1
1534,-15,24,1543,0.66,0
1428,-2,0,1426,0.31,0
1533,10,24,1567,0.69,1
1429,4,0,1433,0.31,0
1532,12,24,1568,0.69,1
1430,24,-3,1451,0.34,0
1531,14,24,1569,0.66,0
1515,26,5,1546,0.58,1
1468,-8,29,1489,0.42,1
1470,-9,0,1461,0.36,0
1513,23,24,1560,0.64,1
1471,-5,-3,1463,0.42,0
1511,-17,24,1518,0.58,1
1470,36,0,1506,0.35,1
1588,-2,24,1610,0.65,1
1471,-6,0,1465,0.29,1
1587,8,24,1619,0.71,1
1469,-8,-1,1460,0.28,1
1589,14,24,1627,0.72,0
1530,-5,0,1525,0.56,1
1466,-7,24,1483,0.44,1
1531,-1,0,1530,0.57,1
1465,-9,24,1480,0.43,1
1532,36,-1,1567,0.57,0
1464,33,24,1521,0.43,0
1437,-20,0,1417,0.43,0
1462,-21,24,1465,0.57,1
1435,-5,-2,1428,0.42,1
1464,-5,24,1483,0.58,0
1542,-16,0,1526,0.56,1
1466,-8,24,1482,0.44,0
1543,40,0,1583,0.65,0
1464,-12,24,1476,0.35,0
1542,0,-3,1539,0.58,1
1466,-4,24,1486,0.42,1
1557,6,0,1563,0.56,0
1464,31,24,1519,0.44,1
1555,-10,0,1545,0.55,1
1466,22,24,1512,0.45,0
1553,30,-2,1581,0.64,1
1468,-6,22,1484,0.36,0
1471,6,0,1477,0.48,1
1462,1,24,1487,0.52,1
1473,-6,0,1467,0.48,0
1460,0,24,1484,0.52,1
1472,28,-2,1498,0.52,1
1461,-5,24,1480,0.48,0
1468,20,0,1488,0.43,1
1525,-11,24,1538,0.57,0
1470,-1,0,1469,0.36,0
1523,19,24,1566,0.64,1
1468,0,-4,1464,0.41,1
1525,-17,20,1528,0.59,0
1589,11,0,1600,0.64,1
1470,3,24,1497,0.36,1
1587,-11,0,1576,0.58,1
1471,28,24,1523,0.42,1
1586,10,-2,1594,0.6,1
1473,22,26,1521,0.4,0
1533,-19,0,1514,0.52,1
1475,0,24,1499,0.48,0
1531,-28,0,1503,0.5,1
1477,5,24,1506,0.5,0
1530,-8,-3,1519,0.52,1
1478,4,22,1504,0.48,1
1479,26,0,1505,0.5,1
1463,20,24,1507,0.5,1
1478,13,0,1491,0.52,1
1464,-12,24,1476,0.48,0
1477,2,-3,1476,0.47,1
1465,14,20,1499,0.53,1
1476,13,0,1489,0.41,1
1515,9,24,1548,0.59,1
1476,-1,0,1475,0.38,1
1514,25,24,1563,0.62,1
1478,28,-2,1504,0.48,0
1513,-17,21,1517,0.52,0
1461,-17,0,1444,0.4,1
1479,11,24,1514,0.6,1
1458,9,0,1467,0.44,1
1482,5,24,1511,0.56,0
1460,-4,0,1456,0.42,1
1480,7,24,1511,0.58,1
1462,2,-2,1462,0.46,0
1478,-12,24,1490,0.54,1
1459,-12,0,1447,0.37,1
1479,33,24,1536,0.63,1
1458,-2,0,1456,0.41,1
1481,13,24,1518,0.59,1
1456,2,0,1458,0.41,1
1483,11,24,1518,0.59,1
1458,-4,-3,1451,0.43,0
1481,1,21,1503,0.57,1
1482,-14,0,1468,0.41,0
1527,-20,24,1531,0.59,1
1481,29,-1,1509,0.45,0
1528,-8,24,1544,0.55,0
1516,-15,0,1501,0.48,1
1483,10,24,1517,0.52,1
1517,-8,0,1509,0.54,0
1482,-22,24,1484,0.46,0
1519,20,-2,1537,0.55,0
1479,-3,24,1500,0.45,1
1481,0,0,1481,0.48,1
1475,-4,24,1495,0.52,1
1482,-7,0,1475,0.42,0
1474,31,24,1529,0.58,1
1479,17,0,1496,0.47,1
1477,18,24,1519,0.53,1
1477,-7,-2,1468,0.49,1
1479,-23,22,1478,0.51,1
1478,-7,0,1471,0.39,0
1546,-21,24,1549,0.61,0
1479,-11,0,1468,0.33,0
1545,22,24,1591,0.67,0
1479,29,-2,1506,0.44,0
1545,-22,26,1549,0.56,0
1478,16,2,1496,0.45,1
1497,5,26,1528,0.55,0
1477,6,0,1483,0.46,1
1499,-10,23,1512,0.54,1
1478,-19,0,1459,0.48,0
1441,7,24,1472,0.52,0
1479,34,0,1513,0.57,0
1439,2,24,1465,0.43,0
1477,17,0,1494,0.55,1
1441,-7,24,1458,0.45,0
1475,4,-2,1477,0.51,1
1443,3,24,1470,0.49,0
1546,-15,0,1531,0.57,1
1473,-17,24,1480,0.43,1
1545,-1,0,1544,0.6,1
1474,-22,24,1476,0.4,1
1548,8,-2,1554,0.53,1
1472,36,24,1532,0.47,1
1442,-2,0,1440,0.4,0
1470,17,24,1511,0.6,1
1440,-2,0,1438,0.45,1
1472,-23,24,1473,0.55,1
1442,1,3,1446,0.43,0
1470,1,24,1495,0.57,1
1472,-6,0,1466,0.37,1
1548,-15,24,1557,0.63,1
1474,-13,0,1461,0.35,1
1545,-4,24,1565,0.65,1
1475,17,-1,1491,0.38,0
1544,6,26,1576,0.62,1
1478,-24,0,1454,0.44,0
1466,2,24,1492,0.56,1
1479,-13,0,1466,0.47,0
1465,-3,24,1486,0.53,1
1481,-6,-3,1472,0.48,1
1463,4,20,1487,0.52,1
1537,-49,0,1488,0.45,1
1483,16,24,1523,0.55,1
1535,-19,0,1516,0.53,1
1484,-11,24,1497,0.47,1
1534,10,-2,1542,0.56,1
1486,-13,26,1499,0.44,1
1510,24,0,1534,0.56,0
1484,-16,24,1492,0.44,1
1508,-3,0,1505,0.47,1
1486,15,24,1525,0.53,0
1506,-4,-3,1499,0.49,1
1488,-5,22,1505,0.51,0
1490,-11,0,1479,0.42,0
1535,-25,24,1534,0.58,1
1491,-8,0,1483,0.38,0
1534,9,24,1567,0.62,1
1492,-17,-1,1474,0.37,0
1532,10,24,1566,0.63,1
1494,18,0,1512,0.38,0
1585,-15,24,1594,0.62,1
1495,-10,0,1485,0.33,0
1584,2,24,1610,0.67,1
1496,-12,0,1484,0.34,0
1584,-9,24,1599,0.66,0
1497,-15,-4,1478,0.31,0
1582,13,20,1615,0.69,1
1499,-7,0,1492,0.47,1
1499,-12,24,1511,0.53,0
1496,30,-3,1523,0.47,1
1502,19,24,1545,0.53,1
1500,-12,0,1488,0.37,1
1554,2,24,1580,0.63,0
1501,-14,0,1487,0.44,0
1553,-49,24,1528,0.56,0
1501,-3,0,1498,0.36,1
1553,20,24,1597,0.64,1
1499,16,-2,1513,0.38,1
1555,19,24,1598,0.62,0
1534,15,0,1549,0.38,0
1589,19,24,1632,0.62,1
1537,6,0,1543,0.42,0
1585,-12,24,1597,0.58,1
1535,15,-3,1547,0.42,1
1587,-3,24,1608,0.58,1
1536,-24,0,1512,0.44,1
1531,0,24,1555,0.56,1
1538,-24,0,1514,0.39,0
1530,37,24,1591,0.61,1
1539,12,0,1551,0.49,0
1529,5,24,1558,0.51,0
1541,-29,-3,1509,0.44,1
1527,2,21,1550,0.56,1
1591,-8,0,1583,0.51,1
1538,12,24,1574,0.49,1
1593,-5,0,1588,0.58,1
1537,-30,24,1531,0.42,1
1591,1,0,1592,0.59,1
1539,-36,24,1527,0.41,1
1590,15,-2,1603,0.58,1
1540,-19,24,1545,0.42,1
1530,0,0,1530,0.49,1
1542,-30,24,1536,0.51,0
1527,-1,0,1526,0.42,1
1545,12,24,1581,0.58,1
1529,3,-2,1530,0.46,0
1543,-6,21,1558,0.54,1
1542,-41,0,1501,0.52,1
1468,-3,24,1489,0.48,0
1543,-25,0,1518,0.56,0
1466,-12,24,1478,0.44,0
1544,-11,0,1533,0.57,1
1465,-7,24,1482,0.43,1
1543,12,0,1555,0.43,1
1549,30,24,1603,0.57,1
1544,-3,0,1541,0.46,1
1548,-2,24,1570,0.54,1
1546,-35,-2,1509,0.4,0
1547,11,22,1580,0.6,1
1544,-14,0,1530,0.52,1
1507,-15,24,1516,0.48,0
1542,-30,0,1512,0.43,1
1509,30,24,1563,0.57,0
1541,11,-1,1551,0.53,1
1511,2,21,1534,0.47,0
1455,17,0,1472,0.38,0
1539,-4,24,1559,0.62,1
1455,1,0,1456,0.37,1
1539,-13,24,1550,0.63,1
1456,-12,-3,1441,0.38,0
1538,-33,24,1529,0.62,1
1518,-12,0,1506,0.41,1
1537,7,24,1568,0.59,1
1514,6,0,1520,0.48,1
1540,-33,24,1531,0.52,0
1515,26,-1,1540,0.48,1
1539,-5,24,1558,0.52,1
1434,7,0,1441,0.35,1
1540,-12,24,1552,0.65,0
1436,-7,0,1429,0.37,0
1538,-39,24,1523,0.63,1
1437,-13,-1,1423,0.31,0
1537,4,22,1563,0.69,1
1535,-39,0,1496,0.44,0
1498,15,24,1537,0.56,0
1537,0,0,1537,0.52,1
1497,-1,24,1520,0.48,1
1536,-11,-3,1522,0.5,1
1498,2,22,1522,0.5,0
1537,5,0,1542,0.48,0
1510,19,24,1553,0.52,1
1536,7,0,1543,0.52,0
1511,-8,24,1527,0.48,0
1535,-19,0,1516,0.51,1
1512,-30,24,1506,0.49,1
1534,-7,-2,1525,0.49,0
1513,0,20,1533,0.51,0
1532,-13,0,1519,0.52,1
1442,40,24,1506,0.48,0
1530,3,0,1533,0.59,1
1444,1,24,1469,0.41,0
1528,7,-2,1533,0.6,1
1446,-7,26,1465,0.4,0
1482,-14,0,1468,0.41,0
1527,-20,24,1531,0.59,1
1481,29,-1,1509,0.45,0
1528,-8,24,1544,0.55,0
1437,13,0,1450,0.36,1
1532,-5,24,1551,0.64,0
1439,1,0,1440,0.34,0
1530,3,24,1557,0.66,1
1437,-4,0,1433,0.37,1
1532,-30,24,1526,0.63,0
1438,8,0,1446,0.34,0
1531,4,24,1559,0.66,1
1435,-5,0,1430,0.36,1
1534,-24,21,1531,0.64,1
1531,-6,0,1525,0.52,1
1528,-42,24,1510,0.48,1
1532,-6,0,1526,0.43,0
1527,22,24,1573,0.57,0
1527,1,-1,1527,0.44,1
1532,16,23,1571,0.56,0
1493,17,0,1510,0.44,1
1526,0,24,1550,0.56,1
1494,-1,0,1493,0.44,1
1525,-17,24,1532,0.56,1
1496,28,0,1524,0.48,0
1523,-6,24,1541,0.52,1
1498,-4,-2,1492,0.43,1
1521,-2,24,1543,0.57,1
1556,0,0,1556,0.53,0
1519,-7,24,1536,0.47,1
1553,-9,0,1544,0.48,1
1522,11,24,1557,0.52,1
1554,-15,-2,1537,0.53,0
1521,-22,20,1519,0.47,1
1523,-33,0,1490,0.49,0
1465,5,24,1494,0.51,1
1521,-4,0,1517,0.55,1
1468,-7,24,1485,0.45,0
1518,-14,-1,1503,0.49,1
1470,16,24,1510,0.51,0
1519,12,0,1531,0.45,0
1542,2,24,1568,0.55,1
1517,-17,-1,1499,0.43,1
1544,-21,26,1549,0.57,1
1533,-44,0,1489,0.41,0
1518,7,24,1549,0.59,0
1532,20,0,1552,0.54,0
1519,-20,24,1523,0.46,0
1530,-30,-1,1499,0.41,1
1521,15,24,1560,0.59,0
1526,23,0,1549,0.51,1
1523,-8,24,1539,0.49,0
1524,-19,0,1505,0.47,1
1526,-22,24,1528,0.53,1
1525,10,-3,1532,0.49,0
1524,-9,24,1539,0.51,1
1526,-18,0,1508,0.58,1
1429,-2,24,1451,0.42,1
1528,12,0,1540,0.66,0
1427,-23,24,1428,0.34,0
1527,-8,-2,1517,0.6,0
1428,-4,22,1446,0.4,0
1527,-20,0,1507,0.37,0
1554,19,24,1597,0.63,0
1525,-11,0,1514,0.43,1
1557,-16,24,1565,0.57,0
1525,-18,0,1507,0.37,1
1556,16,24,1596,0.63,1
1527,13,-3,1537,0.43,0
1554,13,21,1588,0.57,1
1528,-7,0,1521,0.43,0
1528,19,24,1571,0.57,1
1529,-27,0,1502,0.43,0
1527,0,24,1551,0.57,0
1528,-9,-3,1516,0.43,1
1529,13,23,1565,0.57,0
1552,12,0,1564,0.5,0
1529,11,24,1564,0.5,0
1550,12,0,1562,0.53,1
1531,-13,24,1542,0.47,0
1551,-25,0,1526,0.44,0
1530,13,24,1567,0.56,0
1509,-3,0,1506,0.43,1
1533,-4,24,1553,0.57,0
1512,9,0,1521,0.47,0
1530,-14,24,1540,0.53,1
1513,19,0,1532,0.46,0
1528,7,24,1559,0.54,1
1511,3,-1,1513,0.45,1
1530,-8,23,1545,0.55,1
1529,14,0,1543,0.56,1
1468,12,24,1504,0.44,1
1528,-3,0,1525,0.55,1
1469,-4,24,1489,0.45,0
1530,-16,-2,1512,0.56,0
1468,-20,24,1472,0.44,0
1529,9,0,1538,0.45,1
1556,-5,24,1575,0.55,0
1530,-8,0,1522,0.41,0
1555,8,24,1587,0.59,1
1530,14,-2,1542,0.42,1
1554,21,24,1599,0.58,1
1436,-22,0,1414,0.4,1
1465,-6,24,1483,0.6,0
1437,-2,0,1435,0.46,0
1463,-21,24,1466,0.54,0
1440,10,-4,1446,0.44,0
1460,4,24,1488,0.56,1
1529,1,0,1530,0.56,1
1459,8,24,1491,0.44,1
1531,22,0,1553,0.61,1
1456,-1,24,1479,0.39,1
1533,20,0,1553,0.62,0
1455,-9,24,1470,0.38,1
1532,-6,-3,1523,0.6,1
1456,-22,21,1455,0.4,1
1455,2,0,1457,0.47,0
1464,-14,24,1474,0.53,0
1457,12,0,1469,0.48,0
1461,-2,24,1483,0.52,1
1456,3,0,1459,0.43,1
1463,20,24,1507,0.57,1
1455,-9,-2,1444,0.49,1
1464,-38,24,1450,0.51,0
1455,-26,0,1429,0.29,0
1593,-29,24,1588,0.71,0
1456,2,0,1458,0.33,0
1592,-33,24,1583,0.67,1
1457,13,-3,1467,0.29,0
1591,6,24,1621,0.71,1
1461,21,0,1482,0.5,1
1456,5,24,1485,0.5,1
1463,-36,0,1427,0.44,1
1454,-10,24,1468,0.56,1
1460,15,-1,1474,0.48,1
1457,4,26,1487,0.52,0
1587,8,0,1595,0.65,1
1458,3,24,1485,0.35,1
1589,11,0,1600,0.65,1
1456,11,24,1491,0.35,1
1592,-14,-3,1575,0.65,0
1453,-6,21,1468,0.35,1
1454,-17,0,1437,0.33,0
1518,16,24,1558,0.67,1
1456,7,0,1463,0.4,0
1516,-5,24,1535,0.6,1
1455,1,-4,1452,0.39,0
1517,-13,24,1528,0.61,0
1456,12,0,1468,0.47,0
1497,-34,24,1487,0.53,0
1457,-3,0,1454,0.39,1
1496,12,24,1532,0.61,1
1458,-9,-2,1447,0.44,1
1495,-25,21,1491,0.56,1
1549,-1,0,1548,0.59,0
1455,5,24,1484,0.41,1
1550,-42,0,1508,0.54,1
1454,1,24,1479,0.46,1
1553,-9,-3,1541,0.58,1
1451,11,24,1486,0.42,1
1506,8,0,1514,0.56,1
1452,-5,24,1471,0.44,0
1505,-26,0,1479,0.51,1
1454,-7,24,1471,0.49,1
1504,31,-1,1534,0.58,1
1454,3,23,1480,0.42,0
1452,-1,0,1451,0.34,1
1546,-4,24,1566,0.66,0
1449,10,0,1459,0.34,1
1549,3,24,1576,0.66,0
1450,-14,0,1436,0.38,0
1548,-49,24,1523,0.62,0
1452,2,-2,1452,0.31,0
1547,15,26,1588,0.69,1
1450,-9,0,1441,0.33,1
1521,16,24,1561,0.67,0
1451,1,0,1452,0.38,0
1520,-8,24,1536,0.62,0
1449,-1,-1,1447,0.35,1
1522,15,22,1559,0.65,0
1543,3,0,1546,0.61,1
1449,-9,24,1464,0.39,1
1541,-28,0,1513,0.55,1
1451,6,24,1481,0.45,0
1540,25,0,1565,0.63,0
1452,0,24,1476,0.37,0
1538,-1,-3,1534,0.59,1
1454,-3,24,1475,0.41,1
1492,-6,0,1486,0.51,1
1453,4,24,1481,0.49,1
1488,-37,2,1453,0.45,1
1457,4,26,1487,0.55,0
1491,17,-3,1505,0.57,0
1454,-20,20,1454,0.43,1
1455,8,0,1463,0.47,1
1463,-2,24,1485,0.53,1
1454,-5,0,1449,0.46,0
1464,-10,24,1478,0.54,0
1457,4,2,1463,0.48,1
1462,-11,26,1477,0.52,1
1458,3,-2,1459,0.48,0
1460,-11,24,1473,0.52,1
1460,-27,0,1433,0.45,1
1433,8,24,1465,0.55,1
1459,5,0,1464,0.5,0
1434,6,24,1464,0.5,0
1460,-5,-3,1452,0.49,0
1433,3,24,1460,0.51,0
1534,-27,0,1507,0.53,0
1462,1,24,1487,0.47,0
1537,-41,0,1496,0.59,0
1458,-47,24,1435,0.41,1
1536,-17,-2,1517,0.53,1
1460,6,29,1495,0.47,0
1527,15,0,1542,0.58,0
1458,3,24,1485,0.42,1
1525,-11,0,1514,0.54,1
1460,0,24,1484,0.46,1
1524,-6,-3,1515,0.54,1
1461,0,24,1485,0.46,1
1460,-2,0,1458,0.46,1
1462,1,24,1487,0.54,1
1462,-5,0,1457,0.46,1
1460,4,24,1488,0.54,1
1460,15,-3,1472,0.47,1
1462,10,23,1495,0.53,1
1463,2,0,1465,0.4,0
1525,-14,24,1535,0.6,1
1465,2,0,1467,0.4,0
1523,-7,24,1540,0.6,1
1467,0,-3,1464,0.35,1
1522,28,24,1574,0.65,1
1468,1,0,1469,0.44,0
1464,22,24,1510,0.56,1
1467,6,0,1473,0.52,1
1466,-32,24,1458,0.48,0
1468,-1,-3,1464,0.44,0
1464,17,22,1503,0.56,1
1464,-6,0,1458,0.45,1
1467,4,24,1495,0.55,1
1465,-15,0,1450,0.45,0
1466,-2,24,1488,0.55,1
1462,-14,-1,1447,0.42,1
1469,7,26,1502,0.58,0
1478,-24,0,1454,0.44,0
1466,2,24,1492,0.56,1
1479,-13,0,1466,0.47,0
1465,-3,24,1486,0.53,1
1481,-6,-3,1472,0.48,1
1463,4,20,1487,0.52,1
1465,-3,0,1462,0.36,0
1519,19,24,1562,0.64,1
1466,-20,0,1446,0.37,0
1517,-1,24,1540,0.63,1
1468,14,0,1482,0.44,0
1515,-17,24,1522,0.56,1
1470,4,-2,1472,0.41,0
1513,-6,24,1531,0.59,1
1468,-7,0,1461,0.46,1
1471,-5,24,1490,0.54,0
1467,-9,0,1458,0.47,0
1472,-20,24,1476,0.53,0
1471,8,2,1481,0.48,0
1468,-4,26,1490,0.52,1
1513,-17,0,1496,0.47,1
1473,17,24,1514,0.53,1
1514,-6,0,1508,0.51,1
1472,2,24,1498,0.49,1
1516,1,-4,1513,0.55,0
1470,-12,24,1482,0.45,1
1482,-4,0,1478,0.48,1
1471,-5,24,1490,0.52,1
1483,-22,0,1461,0.44,1
1470,6,24,1500,0.56,1
1484,19,0,1503,0.49,1
1469,21,24,1514,0.51,1
1482,-5,-3,1474,0.46,1
1470,6,23,1499,0.54,0
1469,-16,0,1453,0.46,1
1468,-8,24,1484,0.54,0
1467,-6,-3,1458,0.46,1
1469,-5,21,1485,0.54,1
1581,10,0,1591,0.63,1
1465,8,24,1497,0.37,1
1582,-9,0,1573,0.6,0
1463,15,24,1502,0.4,0
1581,13,-3,1591,0.63,1
1464,7,24,1495,0.37,0
1452,-12,0,1440,0.33,0
1539,-3,24,1560,0.67,1
1452,-3,0,1449,0.38,1
1538,-25,24,1537,0.62,1
1454,8,0,1462,0.33,0
1536,28,24,1588,0.67,1
1452,3,-3,1452,0.33,0
1538,16,24,1578,0.67,0
1461,10,0,1471,0.48,0
1450,14,24,1488,0.52,1
1460,4,0,1464,0.5,1
1452,-12,24,1464,0.5,1
1462,-18,0,1444,0.46,0
1450,-2,24,1472,0.54,1
1463,9,-2,1470,0.49,0
1449,6,24,1479,0.51,0
1494,0,0,1494,0.52,0
1447,6,24,1477,0.48,1
1491,9,0,1500,0.54,1
1450,-1,24,1473,0.46,0
1492,-15,-1,1476,0.49,0
1449,13,21,1483,0.51,1
1450,-11,0,1439,0.26,0
1562,34,24,1620,0.74,1
1447,6,0,1453,0.3,1
1564,11,24,1599,0.7,1
1448,10,0,1458,0.33,1
1564,-7,24,1581,0.67,1
1449,-7,-3,1439,0.32,1
1563,-18,24,1569,0.68,1
1447,13,0,1460,0.45,1
1456,13,24,1493,0.55,1
1448,-12,0,1436,0.45,0
1455,-6,24,1473,0.55,1
1446,3,-1,1448,0.44,0
1456,13,22,1491,0.56,0
1484,10,0,1494,0.52,0
1445,10,24,1479,0.48,0
1482,17,0,1499,0.53,1
1447,4,24,1475,0.47,0
1480,19,-2,1497,0.54,1
1449,-7,24,1466,0.46,1
1429,-10,0,1419,0.4,1
1451,11,24,1486,0.6,0
1427,-15,0,1412,0.4,1
1452,4,24,1480,0.6,1
1428,2,-4,1426,0.43,0
1451,3,23,1477,0.57,0
1453,-4,0,1449,0.35,0
1509,26,24,1559,0.65,1
1451,6,0,1457,0.41,1
1510,-10,24,1524,0.59,1
1449,-8,-2,1439,0.36,1
1513,3,21,1537,0.64,0
1451,12,0,1463,0.54,0
1432,-20,24,1436,0.46,1
1450,1,0,1451,0.49,0
1433,-1,24,1456,0.51,0
1447,-6,1,1442,0.43,1
1436,37,20,1493,0.57,0
1446,10,0,1456,0.4,0
1526,-22,24,1528,0.6,0
1447,-8,0,1439,0.33,0
1526,13,24,1563,0.67,1
1448,14,-4,1458,0.38,0
1524,-6,24,1542,0.62,1
1440,-15,0,1425,0.42,1
1450,8,24,1482,0.58,1
1439,22,0,1461,0.49,1
1451,-6,24,1469,0.51,1
1441,-6,0,1435,0.45,0
1449,-3,24,1470,0.55,1
1442,5,-1,1446,0.47,1
1448,-7,24,1465,0.53,1
1556,-21,0,1535,0.57,1
1446,15,24,1485,0.43,1
1555,25,0,1580,0.64,1
1447,8,24,1479,0.36,0
1552,-18,-3,1531,0.59,1
1450,-2,24,1472,0.41,0
1552,2,0,1554,0.62,1
1451,-5,24,1470,0.38,1
1555,-4,0,1551,0.63,0
1447,-10,24,1461,0.37,1
1553,-18,-2,1533,0.56,1
1450,20,23,1493,0.44,0
1451,8,0,1459,0.45,0
1500,-30,24,1494,0.55,1
1453,2,0,1455,0.4,0
1498,6,24,1528,0.6,1
1455,-7,-3,1445,0.42,0
1497,-16,23,1504,0.58,1
1456,7,0,1463,0.36,0
1521,18,24,1563,0.64,1
1453,16,0,1469,0.41,1
1523,-11,24,1536,0.59,0
1455,13,0,1468,0.38,1
1522,6,24,1552,0.62,1
1453,-1,-1,1451,0.37,0
1523,-5,24,1542,0.63,0
1454,-5,0,1449,0.39,1
1467,34,24,1525,0.61,1
1456,12,-3,1465,0.51,1
1465,-24,20,1461,0.49,1
1523,7,0,1530,0.56,1
1457,10,24,1491,0.44,1
1521,19,0,1540,0.56,1
1459,12,24,1495,0.44,0
1520,-5,-2,1513,0.54,1
1460,0,24,1484,0.46,1
1527,-35,0,1492,0.53,1
1462,-14,24,1472,0.47,1
1529,23,0,1552,0.58,0
1460,11,24,1495,0.42,1
1530,-25,0,1505,0.53,0
1459,4,24,1487,0.47,0
1529,15,0,1544,0.59,0
1460,-5,24,1479,0.41,0
1528,-22,-2,1504,0.51,1
1461,12,21,1494,0.49,0
1460,-2,0,1458,0.46,1
1462,1,24,1487,0.54,1
1462,-5,0,1457,0.46,1
1460,4,24,1488,0.54,1
1460,15,-3,1472,0.47,1
1462,10,23,1495,0.53,1
1461,-5,0,1456,0.46,0
1469,-12,24,1481,0.54,0
1458,-5,0,1453,0.44,1
1472,0,24,1496,0.56,0
1460,15,-3,1472,0.47,1
1471,2,21,1494,0.53,1
1462,-3,0,1459,0.49,0
1433,5,24,1462,0.51,1
1463,-5,0,1458,0.5,0
1432,2,24,1458,0.5,1
1462,14,4,1480,0.52,1
1433,0,29,1462,0.48,1
1504,18,0,1522,0.57,1
1465,-13,24,1476,0.43,0
1506,4,-2,1508,0.52,0
1462,11,22,1495,0.48,1
1463,11,-2,1472,0.43,0
1505,-6,24,1523,0.57,0
1562,4,0,1566,0.62,1
1464,-5,24,1483,0.38,1
1561,15,0,1576,0.62,0
1465,-2,24,1487,0.38,0
1558,2,-3,1557,0.61,1
1467,-12,22,1477,0.39,0
1465,7,0,1472,0.37,1
1530,7,24,1561,0.63,0
1466,11,0,1477,0.38,0
1529,13,24,1566,0.62,1
1463,-11,-2,1450,0.41,1
1532,-39,24,1517,0.59,0
1464,2,0,1466,0.36,1
1508,31,24,1563,0.64,1
1466,-5,0,1461,0.42,1
1506,-9,24,1521,0.58,1
1467,9,-4,1472,0.42,0
1505,-2,24,1527,0.58,1
1509,7,0,1516,0.52,0
1468,10,24,1502,0.48,0
1511,-11,0,1500,0.54,0
1467,-16,24,1475,0.46,0
1512,1,-3,1510,0.52,0
1466,3,29,1498,0.48,1
1470,-15,0,1455,0.46,0
1465,-5,24,1484,0.54,0
1468,-7,0,1461,0.45,0
1466,8,24,1498,0.55,0
1467,1,-3,1465,0.45,1
1467,11,24,1502,0.55,0
1468,-11,-2,1455,0.39,1
1502,4,26,1532,0.61,1
1495,-8,0,1487,0.48,1
1470,7,24,1501,0.52,1
1491,2,0,1493,0.49,1
1474,-1,24,1497,0.51,0
1491,-8,2,1485,0.48,0
1473,0,26,1499,0.52,0
1493,30,-3,1520,0.52,0
1472,8,24,1504,0.48,0
1457,-15,0,1442,0.43,0
1433,31,24,1488,0.57,1
1455,12,3,1470,0.54,1
1435,-18,27,1444,0.46,0
1458,9,0,1467,0.43,0
1495,-6,24,1513,0.57,1
1459,-26,0,1433,0.38,1
1494,-3,24,1515,0.62,1
1460,-35,-3,1422,0.35,0
1493,10,24,1527,0.65,1
1461,10,0,1471,0.48,0
1450,14,24,1488,0.52,1
1460,4,0,1464,0.5,1
1452,-12,24,1464,0.5,1
1462,-18,0,1444,0.46,0
1450,-2,24,1472,0.54,1
1463,9,-2,1470,0.49,0
1449,6,24,1479,0.51,0
1464,-30,0,1434,0.34,0
1519,5,24,1548,0.66,1
1466,-13,0,1453,0.38,0
1517,-5,24,1536,0.62,1
1464,7,0,1471,0.39,1
1518,5,24,1547,0.61,1
1463,-5,-2,1456,0.34,0
1520,24,24,1568,0.66,0
1495,31,0,1526,0.54,0
1460,11,24,1495,0.46,1
1498,3,0,1501,0.57,1
1457,-32,24,1449,0.43,1
1499,-29,0,1470,0.53,0
1456,-15,24,1465,0.47,1
1501,-1,-1,1499,0.55,0
1454,-11,24,1467,0.45,1
1447,13,0,1460,0.45,1
1456,13,24,1493,0.55,1
1448,-12,0,1436,0.45,0
1455,-6,24,1473,0.55,1
1446,3,-1,1448,0.44,0
1456,13,22,1491,0.56,0
1455,-13,0,1442,0.37,0
1522,-13,24,1533,0.63,0
1456,14,-1,1469,0.35,0
1522,28,26,1576,0.65,1
1458,1,0,1459,0.52,1
1459,-35,24,1448,0.48,1
1456,-15,0,1441,0.45,1
1460,-8,24,1476,0.55,0
1453,-20,-2,1431,0.4,1
1463,16,24,1503,0.6,0
1455,17,0,1472,0.38,0
1539,-4,24,1559,0.62,1
1455,1,0,1456,0.37,1
1539,-13,24,1550,0.63,1
1456,-12,-3,1441,0.38,0
1538,-33,24,1529,0.62,1
1480,14,0,1494,0.57,0
1454,-35,24,1443,0.43,1
1483,-15,0,1468,0.52,1
1451,-22,24,1453,0.48,1
1480,10,0,1490,0.49,1
1454,20,24,1498,0.51,0
1479,13,-3,1489,0.53,0
1455,-9,24,1470,0.47,0
1521,-31,0,1490,0.51,1
1459,-1,24,1482,0.49,0
1520,13,0,1533,0.62,1
1460,-38,24,1446,0.38,0
1518,27,-2,1543,0.61,1
1462,-21,24,1465,0.39,1
1554,-14,0,1540,0.54,1
1464,22,24,1510,0.46,0
1556,14,0,1570,0.64,0
1462,-18,24,1468,0.36,0
1554,2,-1,1555,0.64,1
1464,-32,24,1456,0.36,0
1463,-7,0,1456,0.5,0
1443,-8,24,1459,0.5,0
1461,-10,0,1451,0.46,1
1444,10,26,1480,0.54,0
1462,-26,0,1436,0.3,1
1576,-13,24,1587,0.7,1
1462,-25,0,1437,0.29,0
1575,-5,24,1594,0.71,0
1464,-14,-2,1448,0.28,0
1574,13,24,1611,0.72,1
1518,-13,0,1505,0.54,0
1463,-10,24,1477,0.46,0
1520,5,0,1525,0.54,0
1461,15,24,1500,0.46,1
1522,-22,0,1500,0.56,0
1459,-26,24,1457,0.44,1
1521,5,0,1526,0.59,1
1460,-23,24,1461,0.41,0
1522,-14,-3,1505,0.56,1
1459,-22,24,1461,0.44,1
1498,11,0,1509,0.57,0
1458,-19,24,1463,0.43,0
1496,25,2,1523,0.57,1
1460,-11,26,1475,0.43,0
1497,-23,-3,1471,0.47,0
1459,15,21,1495,0.53,1
1457,-25,0,1432,0.36,1
1525,-15,24,1534,0.64,0
1458,-23,0,1435,0.32,0
1524,14,24,1562,0.68,0
1459,-17,-3,1439,0.36,1
1524,-10,22,1536,0.64,1
1457,-10,2,1449,0.36,1
1498,24,26,1548,0.64,0
1459,12,-1,1470,0.46,0
1496,-21,24,1499,0.54,1
1460,12,0,1472,0.36,0
1530,17,24,1571,0.64,1
1462,-17,0,1445,0.32,0
1528,23,24,1575,0.68,1
1460,-16,-3,1441,0.34,0
1530,3,24,1557,0.66,0
1435,10,0,1445,0.44,0
1459,6,24,1489,0.56,1
1436,4,0,1440,0.43,0
1457,8,24,1489,0.57,0
1437,0,-2,1435,0.42,0
1456,12,24,1492,0.58,1
1456,-3,0,1453,0.48,1
1458,-17,24,1465,0.52,0
1452,-12,0,1440,0.46,1
1461,-18,24,1467,0.54,0
1450,-12,-4,1434,0.46,1
1463,-20,20,1463,0.54,0
1460,2,-4,1458,0.43,1
1453,36,20,1509,0.57,0
1452,-12,-3,1437,0.42,0
1461,8,21,1490,0.58,0
1463,-9,0,1454,0.36,0
1546,-16,24,1554,0.64,1
1463,9,0,1472,0.38,0
1545,-9,24,1560,0.62,0
1464,-14,0,1450,0.34,0
1545,-5,24,1564,0.66,0
1465,1,-3,1463,0.36,0
1544,-8,24,1560,0.64,0
1440,3,0,1443,0.45,1
1467,-16,24,1475,0.55,0
1440,-2,3,1441,0.42,0
1466,9,25,1500,0.58,0
1467,10,0,1477,0.3,0
1587,12,24,1623,0.7,1
1464,-17,0,1447,0.26,1
1590,10,24,1624,0.74,0
1465,-8,-4,1453,0.32,0
1589,-30,24,1583,0.68,1
1467,2,0,1469,0.38,0
1517,9,24,1550,0.62,1
1468,11,0,1479,0.4,0
1516,13,24,1553,0.6,1
1469,7,-1,1475,0.42,1
1515,-11,26,1530,0.58,1
1468,-7,0,1461,0.46,1
1471,-5,24,1490,0.54,0
1467,-9,0,1458,0.47,0
1472,-20,24,1476,0.53,0
1471,8,2,1481,0.48,0
1468,-4,26,1490,0.52,1
1553,-6,0,1547,0.57,0
1467,8,24,1499,0.43,0
1552,8,0,1560,0.59,1
1468,7,24,1499,0.41,0
1552,16,0,1568,0.61,1
1468,-2,26,1492,0.39,0
1470,-15,0,1455,0.46,0
1465,-5,24,1484,0.54,0
1468,-7,0,1461,0.45,0
1466,8,24,1498,0.55,0
1467,1,-3,1465,0.45,1
1467,11,24,1502,0.55,0
1529,14,0,1543,0.56,1
1468,12,24,1504,0.44,1
1528,-3,0,1525,0.55,1
1469,-4,24,1489,0.45,0
1530,-16,-2,1512,0.56,0
1468,-20,24,1472,0.44,0
1541,-11,0,1530,0.56,1
1470,-5,24,1489,0.44,0
1540,9,0,1549,0.57,1
1472,2,24,1498,0.43,0
1541,26,-2,1565,0.58,1
1471,13,24,1508,0.42,1
1523,26,0,1549,0.51,1
1518,1,24,1543,0.49,0
1525,9,0,1534,0.5,0
1517,-7,24,1534,0.5,1
1523,4,0,1527,0.49,1
1519,-6,24,1537,0.51,0
1519,1,-3,1517,0.43,1
1523,21,24,1568,0.57,0
1535,-36,0,1499,0.41,0
1521,15,24,1560,0.59,1
1533,-36,0,1497,0.43,1
1523,1,23,1547,0.57,0
1522,-8,0,1514,0.5,1
1483,9,24,1516,0.5,1
1523,1,0,1524,0.5,1
1481,17,24,1522,0.5,1
1525,22,-1,1546,0.53,1
1480,20,23,1523,0.47,1
1525,15,0,1540,0.47,1
1519,21,24,1564,0.53,1
1523,-1,0,1522,0.45,1
1522,13,24,1559,0.55,0
1521,-13,-2,1506,0.45,1
1523,-6,20,1537,0.55,0
1454,26,0,1480,0.4,0
1522,3,24,1549,0.6,0
1455,1,0,1456,0.34,0
1522,24,24,1570,0.66,1
1455,-24,-1,1430,0.33,0
1521,9,21,1551,0.67,0
1522,-3,0,1519,0.45,0
1502,30,24,1556,0.55,1
1523,-13,0,1510,0.48,1
1501,3,24,1528,0.52,1
1521,-6,0,1515,0.52,1
1503,-24,24,1503,0.48,0
1522,-1,0,1521,0.5,0
1502,-5,24,1521,0.5,0
1519,23,-3,1539,0.51,1
1505,5,24,1534,0.49,0
1454,-17,0,1437,0.33,0
1518,16,24,1558,0.67,1
1456,7,0,1463,0.4,0
1516,-5,24,1535,0.6,1
1455,1,-4,1452,0.39,0
1517,-13,24,1528,0.61,0
1511,-9,0,1502,0.45,0
1516,-5,24,1535,0.55,0
1510,11,0,1521,0.43,1
1518,29,24,1571,0.57,1
1509,-18,-2,1489,0.4,1
1519,18,23,1560,0.6,1
1522,-3,0,1519,0.53,0
1463,11,24,1498,0.47,1
1518,-18,0,1500,0.51,1
1467,-1,24,1490,0.49,0
1521,6,-1,1526,0.55,0
1464,-1,26,1489,0.45,1
1519,27,0,1546,0.54,1
1498,0,24,1522,0.46,0
1521,24,0,1545,0.51,0
1496,21,24,1541,0.49,1
1520,-4,-3,1513,0.49,0
1497,-3,24,1518,0.51,0
1530,6,0,1536,0.53,1
1522,-29,24,1517,0.47,0
1531,-17,0,1514,0.49,1
1521,-26,24,1519,0.51,1
1533,11,-3,1541,0.48,1
1519,8,24,1551,0.52,1
1575,18,0,1593,0.6,1
1520,-19,24,1525,0.4,1
1578,6,0,1584,0.57,0
1517,-7,24,1534,0.43,1
1577,2,-1,1578,0.58,1
1519,-24,23,1518,0.42,1
1517,11,0,1528,0.4,1
1554,20,24,1598,0.6,1
1520,-14,0,1506,0.4,0
1552,-3,24,1573,0.6,1
1517,-28,-2,1487,0.4,1
1555,-18,24,1561,0.6,0
1518,-13,0,1505,0.54,0
1463,-10,24,1477,0.46,0
1520,5,0,1525,0.54,0
1461,15,24,1500,0.46,1
1522,-22,0,1500,0.56,0
1459,-26,24,1457,0.44,1
1521,5,0,1526,0.59,1
1460,-23,24,1461,0.41,0
1522,-14,-3,1505,0.56,1
1459,-22,24,1461,0.44,1
1456,7,0,1463,0.36,0
1521,18,24,1563,0.64,1
1453,16,0,1469,0.41,1
1523,-11,24,1536,0.59,0
1455,13,0,1468,0.38,1
1522,6,24,1552,0.62,1
1453,-1,-1,1451,0.37,0
1523,-5,24,1542,0.63,0
1457,-25,0,1432,0.36,1
1525,-15,24,1534,0.64,0
1458,-23,0,1435,0.32,0
1524,14,24,1562,0.68,0
1459,-17,-3,1439,0.36,1
1524,-10,22,1536,0.64,1
1523,7,0,1530,0.56,1
1457,10,24,1491,0.44,1
1521,19,0,1540,0.56,1
1459,12,24,1495,0.44,0
1520,-5,-2,1513,0.54,1
1460,0,24,1484,0.46,1
1517,15,0,1532,0.6,1
1454,-15,24,1463,0.4,1
1519,-13,0,1506,0.55,0
1452,-3,24,1473,0.45,1
1518,-9,-4,1505,0.55,0
1453,-4,24,1473,0.45,0
1500,8,0,1508,0.43,0
1517,17,24,1558,0.57,0
1499,26,0,1525,0.49,0
1518,-7,24,1535,0.51,0
1500,-17,3,1486,0.4,1
1516,17,24,1557,0.6,1
1552,-3,0,1549,0.5,1
1518,3,24,1545,0.5,0
1549,-9,0,1540,0.5,1
1521,-5,24,1540,0.5,0
1547,42,-1,1588,0.53,1
1523,21,26,1570,0.47,0
1452,-18,0,1434,0.35,0
1523,-7,24,1540,0.65,1
1453,-4,0,1449,0.35,0
1522,12,24,1558,0.65,0
1454,-11,-2,1441,0.37,0
1521,-6,21,1536,0.63,0
1523,-4,0,1519,0.62,0
1432,-19,24,1437,0.38,1
1526,-4,0,1522,0.6,1
1429,-4,24,1449,0.4,1
1524,22,0,1546,0.63,1
1430,0,24,1454,0.37,0
1524,-10,-3,1511,0.58,0
1431,0,24,1455,0.42,0
1521,-18,0,1503,0.47,1
1528,-31,24,1521,0.53,0
1517,-5,0,1512,0.41,1
1531,19,24,1574,0.59,0
1519,0,-3,1516,0.44,0
1529,6,24,1559,0.56,1
1467,2,0,1469,0.38,0
1517,9,24,1550,0.62,1
1468,11,0,1479,0.4,0
1516,13,24,1553,0.6,1
1469,7,-1,1475,0.42,1
1515,-11,26,1530,0.58,1
1534,29,0,1563,0.54,1
1514,-2,24,1536,0.46,1
1536,-31,0,1505,0.46,0
1511,-2,24,1533,0.54,1
1537,1,-3,1535,0.49,0
1510,10,22,1542,0.51,0
1509,7,0,1516,0.52,0
1468,10,24,1502,0.48,0
1511,-11,0,1500,0.54,0
1467,-16,24,1475,0.46,0
1512,1,-3,1510,0.52,0
1466,3,29,1498,0.48,1
1509,-3,0,1506,0.43,1
1533,-4,24,1553,0.57,0
1512,9,0,1521,0.47,0
1530,-14,24,1540,0.53,1
1513,19,0,1532,0.46,0
1528,7,24,1559,0.54,1
1511,3,-1,1513,0.45,1
1530,-8,23,1545,0.55,1
1580,9,0,1589,0.59,1
1513,-9,24,1528,0.41,0
1578,-16,-1,1561,0.53,1
1515,0,24,1539,0.47,0
1501,0,0,1501,0.45,0
1514,-5,24,1533,0.55,1
1503,13,0,1516,0.45,1
1512,13,24,1549,0.55,1
1502,2,0,1504,0.42,1
1513,23,24,1560,0.58,0
1501,37,-3,1535,0.49,0
1514,5,24,1543,0.51,0
1523,26,0,1549,0.51,1
1518,1,24,1543,0.49,0
1525,9,0,1534,0.5,0
1517,-7,24,1534,0.5,1
1523,4,0,1527,0.49,1
1519,-6,24,1537,0.51,0
1519,1,-3,1517,0.43,1
1523,21,24,1568,0.57,0
1518,4,0,1522,0.52,0
1494,-12,24,1506,0.48,0
1516,25,0,1541,0.57,1
1496,-31,24,1489,0.43,0
1517,-14,0,1503,0.44,0
1494,27,24,1545,0.56,1
1519,17,-2,1534,0.53,1
1492,-3,21,1510,0.47,1
1464,-30,0,1434,0.34,0
1519,5,24,1548,0.66,1
1466,-13,0,1453,0.38,0
1517,-5,24,1536,0.62,1
1464,7,0,1471,0.39,1
1518,5,24,1547,0.61,1
1463,-5,-2,1456,0.34,0
1520,24,24,1568,0.66,0
1525,15,0,1540,0.47,1
1519,21,24,1564,0.53,1
1523,-1,0,1522,0.45,1
1522,13,24,1559,0.55,0
1521,-13,-2,1506,0.45,1
1523,-6,20,1537,0.55,0
1520,0,0,1520,0.47,1
1518,0,24,1542,0.53,1
1518,24,0,1542,0.47,1
1520,22,24,1566,0.53,0
1517,18,0,1535,0.51,0
1521,-16,26,1531,0.49,0
1519,17,0,1536,0.46,0
1507,32,24,1563,0.54,1
1516,-3,0,1513,0.51,1
1509,-25,24,1508,0.49,1
1517,-2,-4,1511,0.47,0
1508,0,24,1532,0.53,1
1456,2,0,1458,0.36,0
1517,21,24,1562,0.64,1
1453,-26,0,1427,0.31,1
1519,20,24,1563,0.69,0
1451,-1,0,1450,0.34,1
1522,18,24,1564,0.66,0
1448,-8,-3,1437,0.35,1
1524,-1,24,1547,0.65,0
1547,-7,0,1540,0.48,1
1527,5,24,1556,0.52,1
1548,8,0,1556,0.49,1
1526,14,24,1564,0.51,1
1549,8,-2,1555,0.48,1
1525,22,21,1568,0.52,1
1526,21,0,1547,0.46,0
1547,1,24,1572,0.54,1
1522,-7,0,1515,0.36,1
1550,40,24,1614,0.64,0
1525,13,-1,1537,0.45,0
1548,3,24,1575,0.55,1
1521,-31,0,1490,0.51,1
1459,-1,24,1482,0.49,0
1520,13,0,1533,0.62,1
1460,-38,24,1446,0.38,0
1518,27,-2,1543,0.61,1
1462,-21,24,1465,0.39,1
1479,7,0,1486,0.39,1
1520,22,24,1566,0.61,1
1477,21,0,1498,0.41,1
1522,15,24,1561,0.59,1
1479,1,0,1480,0.44,0
1520,-19,24,1525,0.56,1
1590,-14,0,1576,0.53,1
1521,14,24,1559,0.47,1
1588,6,0,1594,0.58,1
1522,-11,24,1535,0.42,0
1590,-33,-2,1555,0.49,0
1520,16,23,1559,0.51,1
1519,21,0,1540,0.51,1
1530,-17,24,1537,0.49,1
1518,16,0,1534,0.46,0
1531,8,24,1563,0.54,0
1519,-15,-3,1501,0.39,0
1530,25,21,1576,0.61,1
1521,-12,0,1509,0.37,0
1553,24,24,1601,0.63,1
1523,22,0,1545,0.48,0
1551,-18,24,1557,0.52,1
1524,24,0,1548,0.43,1
1550,22,22,1594,0.57,1
1479,19,0,1498,0.42,1
1523,10,24,1557,0.58,1
1477,-9,0,1468,0.4,1
1525,-12,26,1539,0.6,0
1531,-6,0,1525,0.52,1
1528,-42,24,1510,0.48,1
1532,-6,0,1526,0.43,0
1527,22,24,1573,0.57,0
1527,1,-1,1527,0.44,1
1532,16,23,1571,0.56,0
1529,13,0,1542,0.42,1
1572,0,24,1596,0.58,0
1527,-16,0,1511,0.39,0
1574,-5,24,1593,0.61,0
1528,-38,-1,1489,0.34,1
1573,8,24,1605,0.66,1
1527,-35,0,1492,0.53,1
1462,-14,24,1472,0.47,1
1529,23,0,1552,0.58,0
1460,11,24,1495,0.42,1
1530,-25,0,1505,0.53,0
1459,4,24,1487,0.47,0
1529,15,0,1544,0.59,0
1460,-5,24,1479,0.41,0
1528,-22,-2,1504,0.51,1
1461,12,21,1494,0.49,0
1571,4,0,1575,0.51,1
1529,12,24,1565,0.49,0
1572,-3,0,1569,0.58,0
1528,-40,24,1512,0.42,0
1570,17,0,1587,0.59,1
1530,-28,24,1526,0.41,1
1567,-22,-3,1542,0.45,1
1533,19,26,1578,0.55,1
1501,6,0,1507,0.4,0
1532,22,24,1578,0.6,1
1499,-11,-2,1486,0.39,1
1534,6,21,1561,0.61,1
1533,-44,0,1489,0.41,0
1518,7,24,1549,0.59,0
1532,20,0,1552,0.54,0
1519,-20,24,1523,0.46,0
1530,-30,-1,1499,0.41,1
1521,15,24,1560,0.59,0
1529,24,0,1553,0.58,1
1478,-4,24,1498,0.42,0
1528,5,-1,1532,0.55,0
1479,-8,25,1496,0.45,0
1527,7,0,1534,0.46,0
1527,14,24,1565,0.54,0
1526,1,0,1527,0.52,1
1528,-40,24,1512,0.48,1
1528,-26,0,1502,0.48,0
1526,-34,24,1516,0.52,1
1525,-17,-4,1504,0.39,1
1528,28,24,1580,0.61,0
1465,7,0,1472,0.37,1
1530,7,24,1561,0.63,0
1466,11,0,1477,0.38,0
1529,13,24,1566,0.62,1
1463,-11,-2,1450,0.41,1
1532,-39,24,1517,0.59,0
1534,29,0,1563,0.54,1
1514,-2,24,1536,0.46,1
1536,-31,0,1505,0.46,0
1511,-2,24,1533,0.54,1
1537,1,-3,1535,0.49,0
1510,10,22,1542,0.51,0
1539,16,0,1555,0.55,0
1499,-7,24,1516,0.45,1
1540,-18,0,1522,0.51,0
1498,-5,24,1517,0.49,0
1543,-31,3,1515,0.44,0
1495,30,29,1554,0.56,1
1524,-18,0,1506,0.46,1
1545,-34,24,1535,0.54,0
1525,12,0,1537,0.47,0
1545,-9,24,1560,0.53,0
1526,12,-3,1535,0.44,0
1544,11,24,1579,0.56,0
1497,7,0,1504,0.43,1
1546,-19,24,1551,0.57,0
1499,38,0,1537,0.5,1
1545,-31,24,1538,0.5,1
1500,-12,-2,1486,0.43,0
1544,-34,24,1534,0.57,0
1541,-11,0,1530,0.56,1
1470,-5,24,1489,0.44,0
1540,9,0,1549,0.57,1
1472,2,24,1498,0.43,0
1541,26,-2,1565,0.58,1
1471,13,24,1508,0.42,1
1590,-20,0,1570,0.49,1
1560,-8,24,1576,0.51,1
1591,-6,4,1589,0.49,0
1559,2,31,1592,0.51,0
1534,15,0,1549,0.38,0
1589,19,24,1632,0.62,1
1537,6,0,1543,0.42,0
1585,-12,24,1597,0.58,1
1535,15,-3,1547,0.42,1
1587,-3,24,1608,0.58,1
1470,36,0,1506,0.35,1
1588,-2,24,1610,0.65,1
1471,-6,0,1465,0.29,1
1587,8,24,1619,0.71,1
1469,-8,-1,1460,0.28,1
1589,14,24,1627,0.72,0
1591,-8,0,1583,0.51,1
1538,12,24,1574,0.49,1
1593,-5,0,1588,0.58,1
1537,-30,24,1531,0.42,1
1591,1,0,1592,0.59,1
1539,-36,24,1527,0.41,1
1590,15,-2,1603,0.58,1
1540,-19,24,1545,0.42,1
1587,4,0,1591,0.68,1
1438,-2,24,1460,0.32,0
1590,-6,0,1584,0.65,0
1435,12,26,1473,0.35,1
1591,-8,0,1583,0.58,0
1499,2,24,1525,0.42,0
1590,-2,0,1588,0.61,1
1501,-16,24,1509,0.39,0
1588,16,-1,1603,0.65,1
1503,-35,26,1494,0.35,1
1589,2,-3,1588,0.53,0
1557,-8,21,1570,0.47,0
1429,-1,0,1428,0.26,0
1588,-4,24,1608,0.74,1
1429,36,0,1465,0.35,0
1588,-38,24,1574,0.65,0
1430,0,-3,1427,0.27,1
1587,-7,24,1604,0.73,1
1554,-20,0,1534,0.39,0
1586,-1,24,1609,0.61,1
1552,0,0,1552,0.4,0
1588,14,24,1626,0.6,0
1550,32,0,1582,0.45,0
1589,3,24,1616,0.55,0
1551,3,-3,1551,0.41,1
1589,1,21,1611,0.59,1
1588,-3,0,1585,0.57,1
1528,-14,24,1538,0.43,1
1589,2,0,1591,0.55,1
1527,2,24,1553,0.45,1
1588,7,-3,1592,0.52,1
1528,29,21,1578,0.48,0
1589,3,0,1592,0.57,1
1547,-29,24,1542,0.43,1
1587,-4,0,1583,0.47,1
1549,29,24,1602,0.53,0
1584,-5,-2,1577,0.51,1
1553,-8,24,1569,0.49,0
1531,2,0,1533,0.47,0
1583,-52,24,1555,0.53,0
1531,31,0,1562,0.43,0
1582,3,24,1609,0.57,1
1532,5,-1,1536,0.39,0
1581,6,26,1613,0.61,0
1471,-17,0,1454,0.3,1
1579,-1,24,1602,0.7,1
1473,-2,0,1471,0.33,0
1577,-8,24,1593,0.67,1
1474,4,3,1481,0.33,0
1577,4,21,1602,0.67,0
1575,18,0,1593,0.6,1
1520,-19,24,1525,0.4,1
1578,6,0,1584,0.57,0
1517,-7,24,1534,0.43,1
1577,2,-1,1578,0.58,1
1519,-24,23,1518,0.42,1
1462,-26,0,1436,0.3,1
1576,-13,24,1587,0.7,1
1462,-25,0,1437,0.29,0
1575,-5,24,1594,0.71,0
1464,-14,-2,1448,0.28,0
1574,13,24,1611,0.72,1
1520,-11,0,1509,0.38,0
1573,-1,24,1596,0.62,0
1522,26,2,1550,0.42,0
1571,6,26,1603,0.58,1
1524,3,-2,1525,0.42,0
1569,-12,23,1580,0.58,1
1570,-1,0,1569,0.49,0
1530,24,24,1578,0.51,1
1572,14,0,1586,0.55,0
1529,0,24,1553,0.45,0
1570,-4,0,1566,0.52,0
1530,-1,24,1553,0.48,0
1568,5,-3,1570,0.55,1
1532,-19,24,1537,0.45,0
1436,8,0,1444,0.35,0
1568,-39,24,1553,0.65,0
1437,2,0,1439,0.31,1
1567,-10,24,1581,0.69,1
1434,6,-2,1438,0.27,1
1569,16,24,1609,0.73,1
1529,13,0,1542,0.42,1
1572,0,24,1596,0.58,0
1527,-16,0,1511,0.39,0
1574,-5,24,1593,0.61,0
1528,-38,-1,1489,0.34,1
1573,8,24,1605,0.66,1
1575,-7,0,1568,0.65,1
1431,3,24,1458,0.35,1
1575,16,0,1591,0.68,0
1431,1,24,1456,0.32,0
1574,-4,0,1570,0.69,1
1432,-27,24,1429,0.31,1
1573,-2,-3,1568,0.66,1
1433,1,22,1456,0.34,0
1571,4,0,1575,0.51,1
1529,12,24,1565,0.49,0
1572,-3,0,1569,0.58,0
1528,-40,24,1512,0.42,0
1570,17,0,1587,0.59,1
1530,-28,24,1526,0.41,1
1567,-22,-3,1542,0.45,1
1533,19,26,1578,0.55,1
1547,5,0,1552,0.45,0
1566,-3,24,1587,0.55,1
1548,-27,0,1521,0.4,1
1565,-1,24,1588,0.6,1
1471,8,0,1479,0.35,0
1564,-2,24,1586,0.65,0
1469,-7,0,1462,0.33,1
1566,-3,24,1587,0.67,0
1470,15,6,1491,0.33,0
1566,17,29,1612,0.67,0
1567,1,0,1568,0.54,0
1550,-32,24,1542,0.46,0
1564,-5,0,1559,0.44,1
1553,23,24,1600,0.56,0
1563,-4,-3,1556,0.49,0
1554,-14,24,1564,0.51,0
1562,4,0,1566,0.62,1
1464,-5,24,1483,0.38,1
1561,15,0,1576,0.62,0
1465,-2,24,1487,0.38,0
1558,2,-3,1557,0.61,1
1467,-12,22,1477,0.39,0
1429,2,0,1431,0.3,1
1557,-4,24,1577,0.7,1
1430,-3,0,1427,0.3,0
1556,-5,24,1575,0.7,1
1431,4,-2,1433,0.29,1
1555,5,26,1586,0.71,1
1499,-13,0,1486,0.36,0
1553,11,24,1588,0.64,1
1500,2,0,1502,0.39,1
1553,0,24,1577,0.61,1
1501,-18,-2,1481,0.37,0
1552,-2,22,1572,0.63,1
1553,-6,0,1547,0.57,0
1467,8,24,1499,0.43,0
1552,8,0,1560,0.59,1
1468,7,24,1499,0.41,0
1552,16,0,1568,0.61,1
1468,-2,26,1492,0.39,0
1555,-5,0,1550,0.64,0
1427,-5,24,1446,0.36,1
1554,-2,0,1552,0.64,1
1428,-3,24,1449,0.36,0
1555,-7,-2,1546,0.63,0
1427,0,26,1453,0.37,0
1553,11,0,1564,0.47,0
1553,5,24,1582,0.53,0
1551,16,0,1567,0.46,1
1555,18,24,1597,0.54,1
1553,-23,0,1530,0.44,0
1553,-8,24,1569,0.56,1
1551,19,-2,1568,0.48,0
1555,-1,24,1578,0.52,0
1529,9,0,1538,0.45,1
1556,-5,24,1575,0.55,0
1530,-8,0,1522,0.41,0
1555,8,24,1587,0.59,1
1530,14,-2,1542,0.42,1
1554,21,24,1599,0.58,1
